Município ,Cidade,Zona Eleitoral ,Local de Votação ,Seção Eleitoral ,Eleitores faltosos ,Habilitados por ano nascimento ,LULA 13 ,JAIR BOLSONARO 22 ,Eleitores Aptos ,Total de votos Nominais ,Brancos ,Nulos ,Total Apurado ,
01007, BUJARI ,0009,1104,0001,0074,0019,0075,0175,0335,0250,0005,0006,0261,
01007, BUJARI ,0009,1104,0002,0075,0023,0074,0183,0338,0257,0002,0004,0263,
01007, BUJARI ,0009,1104,0003,0087,0021,0075,0165,0330,0240,0002,0001,0243,
01007, BUJARI ,0009,1104,0004,0082,0022,0089,0154,0333,0243,0005,0003,0251,
01007, BUJARI ,0009,1112,0005,0087,0028,0063,0150,0311,0213,0005,0006,0224,
01007, BUJARI ,0009,1112,0006,0079,0006,0057,0171,0317,0228,0006,0004,0238,
01007, BUJARI ,0009,1023,0007,0108,0037,0076,0133,0320,0209,0000,0003,0212,
01007, BUJARI ,0009,1023,0008,0093,0022,0046,0134,0275,0180,0000,0002,0182,
01007, BUJARI ,0009,1023,0009,0108,0021,0065,0143,0322,0208,0003,0003,0214,
01007, BUJARI ,0009,1023,0010,0084,0014,0049,0137,0277,0186,0002,0005,0193,
01007, BUJARI ,0009,1112,0120,0079,0016,0059,0170,0316,0229,0004,0004,0237,
01007, BUJARI ,0009,1023,0136,0108,0035,0052,0102,0270,0154,0002,0006,0162,
01007, BUJARI ,0009,1112,0137,0086,0023,0059,0162,0317,0221,0004,0006,0231,
01007, BUJARI ,0009,1040,0163,0079,0004,0019,0096,0194,0115,0000,0000,0115,
01007, BUJARI ,0009,1112,0186,0094,0021,0064,0148,0315,0212,0001,0008,0221,
01007, BUJARI ,0009,1058,0192,0091,0033,0053,0179,0330,0232,0005,0002,0239,
01007, BUJARI ,0009,1066,0200,0081,0005,0068,0109,0261,0177,0001,0002,0180,
01007, BUJARI ,0009,1074,0201,0099,0019,0022,0137,0262,0159,0001,0003,0163,
01007, BUJARI ,0009,1058,0202,0100,0045,0066,0160,0333,0226,0003,0004,0233,
01007, BUJARI ,0009,1058,0208,0089,0034,0069,0166,0327,0235,0001,0002,0238,
01007, BUJARI ,0009,1082,0212,0104,0030,0078,0141,0332,0219,0004,0005,0228,
01007, BUJARI ,0009,1082,0237,0133,0007,0057,0136,0331,0193,0003,0002,0198,
01007, BUJARI ,0009,1090,0242,0089,0006,0052,0123,0270,0175,0005,0001,0181,
01007, BUJARI ,0009,1090,0252,0088,0015,0067,0115,0276,0182,0003,0003,0188,
01007, BUJARI ,0009,1112,0304,0110,0014,0046,0145,0310,0191,0003,0006,0200,
01007, BUJARI ,0009,1104,0305,0114,0016,0061,0137,0321,0198,0003,0006,0207,
01007, BUJARI ,0009,1066,0310,0050,0002,0029,0064,0145,0093,0002,0000,0095,
01007, BUJARI ,0009,1090,0411,0060,0002,0032,0079,0172,0111,0001,0000,0112,
01007, BUJARI ,0009,1112,0412,0132,0013,0046,0131,0315,0177,0006,0000,0183,
01007, BUJARI ,0009,1074,0413,0040,0010,0008,0062,0112,0070,0000,0002,0072,
01007, BUJARI ,0009,1104,0419,0123,0007,0052,0152,0331,0204,0002,0002,0208,
01007, BUJARI ,0009,1120,0436,0098,0008,0065,0106,0270,0171,0001,0000,0172,
01007, BUJARI ,0009,1120,0437,0073,0006,0053,0110,0239,0163,0002,0001,0166,
01007, BUJARI ,0009,1112,0441,0078,0002,0070,0155,0308,0225,0001,0004,0230,
01007, BUJARI ,0009,1147,0442,0027,0006,0042,0063,0133,0105,0000,0001,0106,
01015, CAPIXABA ,0002,1015,0065,0070,0035,0062,0155,0291,0217,0001,0003,0221,
01015, CAPIXABA ,0002,1015,0066,0070,0053,0056,0162,0294,0218,0003,0003,0224,
01015, CAPIXABA ,0002,1015,0067,0070,0041,0053,0164,0294,0217,0003,0004,0224,
01015, CAPIXABA ,0002,1015,0068,0080,0032,0050,0158,0291,0208,0001,0002,0211,
01015, CAPIXABA ,0002,1023,0069,0062,0018,0053,0125,0245,0178,0002,0003,0183,
01015, CAPIXABA ,0002,1023,0070,0057,0034,0054,0126,0242,0180,0001,0004,0185,
01015, CAPIXABA ,0002,1023,0071,0053,0026,0043,0139,0239,0182,0003,0001,0186,
01015, CAPIXABA ,0002,1023,0072,0067,0028,0041,0132,0242,0173,0000,0002,0175,
01015, CAPIXABA ,0002,1031,0073,0083,0022,0045,0138,0269,0183,0002,0001,0186,
01015, CAPIXABA ,0002,1031,0074,0091,0023,0048,0129,0268,0177,0000,0000,0177,
01015, CAPIXABA ,0002,1031,0075,0088,0029,0047,0129,0264,0176,0000,0000,0176,
01015, CAPIXABA ,0002,1058,0077,0064,0030,0045,0117,0230,0162,0001,0003,0166,
01015, CAPIXABA ,0002,1058,0078,0087,0015,0030,0110,0228,0140,0000,0001,0141,
01015, CAPIXABA ,0002,1066,0079,0097,0036,0074,0126,0299,0200,0001,0001,0202,
01015, CAPIXABA ,0002,1066,0080,0080,0043,0098,0124,0308,0222,0002,0004,0228,
01015, CAPIXABA ,0002,1066,0081,0097,0028,0050,0126,0278,0176,0001,0004,0181,
01015, CAPIXABA ,0002,1066,0082,0098,0021,0059,0103,0261,0162,0000,0001,0163,
01015, CAPIXABA ,0002,1104,0087,0088,0026,0034,0112,0236,0146,0000,0002,0148,
01015, CAPIXABA ,0002,1112,0088,0057,0025,0053,0084,0196,0137,0001,0001,0139,
01015, CAPIXABA ,0002,1112,0089,0067,0009,0039,0089,0196,0128,0001,0000,0129,
01015, CAPIXABA ,0002,1120,0090,0070,0030,0047,0144,0264,0191,0001,0002,0194,
01015, CAPIXABA ,0002,1120,0091,0072,0022,0055,0136,0266,0191,0002,0001,0194,
01015, CAPIXABA ,0002,1120,0092,0064,0025,0043,0158,0269,0201,0002,0002,0205,
01015, CAPIXABA ,0002,1120,0093,0108,0032,0056,0171,0336,0227,0000,0001,0228,
01015, CAPIXABA ,0002,1155,0094,0078,0016,0049,0135,0265,0184,0002,0001,0187,
01015, CAPIXABA ,0002,1155,0095,0092,0026,0034,0133,0260,0167,0001,0000,0168,
01015, CAPIXABA ,0002,1228,0101,0033,0004,0005,0075,0113,0080,0000,0000,0080,
01015, CAPIXABA ,0002,1236,0102,0066,0026,0041,0129,0242,0170,0000,0006,0176,
01015, CAPIXABA ,0002,1236,0103,0083,0025,0068,0156,0308,0224,0000,0001,0225,
01015, CAPIXABA ,0002,1252,0105,0071,0022,0046,0126,0245,0172,0000,0002,0174,
01015, CAPIXABA ,0002,1015,0107,0023,0003,0019,0052,0097,0071,0003,0000,0074,
01023, PORTO ACRE ,0001,1015,0576,0068,0009,0052,0126,0248,0178,0001,0001,0180,
01023, PORTO ACRE ,0001,1015,0577,0055,0007,0056,0138,0251,0194,0001,0001,0196,
01023, PORTO ACRE ,0001,1015,0578,0057,0000,0059,0128,0250,0187,0002,0004,0193,
01023, PORTO ACRE ,0001,1015,0579,0067,0005,0062,0116,0250,0178,0002,0003,0183,
01023, PORTO ACRE ,0001,1015,0580,0083,0004,0041,0116,0246,0157,0004,0002,0163,
01023, PORTO ACRE ,0001,1015,0581,0089,0004,0042,0117,0249,0159,0000,0001,0160,
01023, PORTO ACRE ,0001,1015,0582,0095,0008,0039,0115,0250,0154,0000,0001,0155,
01023, PORTO ACRE ,0001,1023,0583,0074,0008,0051,0169,0297,0220,0001,0002,0223,
01023, PORTO ACRE ,0001,1023,0584,0068,0015,0050,0168,0294,0218,0002,0006,0226,
01023, PORTO ACRE ,0001,1023,0585,0058,0022,0044,0184,0289,0228,0001,0002,0231,
01023, PORTO ACRE ,0001,1023,0586,0065,0007,0056,0167,0294,0223,0000,0006,0229,
01023, PORTO ACRE ,0001,1023,0587,0056,0008,0061,0169,0295,0230,0004,0005,0239,
01023, PORTO ACRE ,0001,1023,0588,0075,0012,0054,0160,0293,0214,0001,0003,0218,
01023, PORTO ACRE ,0001,1031,0589,0070,0011,0041,0124,0236,0165,0000,0001,0166,
01023, PORTO ACRE ,0001,1031,0590,0055,0026,0034,0139,0232,0173,0003,0001,0177,
01023, PORTO ACRE ,0001,1031,0591,0066,0017,0029,0141,0239,0170,0002,0001,0173,
01023, PORTO ACRE ,0001,1031,0592,0059,0009,0044,0126,0236,0170,0003,0004,0177,
01023, PORTO ACRE ,0001,1031,0593,0062,0009,0034,0138,0235,0172,0001,0000,0173,
01023, PORTO ACRE ,0001,1031,0594,0076,0005,0027,0130,0237,0157,0002,0002,0161,
01023, PORTO ACRE ,0001,1031,0595,0061,0005,0029,0147,0239,0176,0000,0002,0178,
01023, PORTO ACRE ,0001,1040,0596,0057,0013,0147,0080,0289,0227,0001,0004,0232,
01023, PORTO ACRE ,0001,1066,0598,0067,0012,0050,0161,0278,0211,0000,0000,0211,
01023, PORTO ACRE ,0001,1066,0599,0070,0033,0066,0137,0278,0203,0002,0003,0208,
01023, PORTO ACRE ,0001,1066,0600,0072,0009,0052,0146,0274,0198,0002,0002,0202,
01023, PORTO ACRE ,0001,1074,0601,0095,0015,0070,0144,0313,0214,0000,0004,0218,
01023, PORTO ACRE ,0001,1074,0602,0032,0015,0032,0090,0156,0122,0001,0001,0124,
01023, PORTO ACRE ,0001,1082,0604,0053,0020,0050,0133,0239,0183,0001,0002,0186,
01023, PORTO ACRE ,0001,1082,0605,0046,0043,0037,0142,0228,0179,0001,0002,0182,
01023, PORTO ACRE ,0001,1082,0606,0046,0011,0043,0133,0223,0176,0001,0000,0177,
01023, PORTO ACRE ,0001,1082,0607,0035,0010,0040,0145,0227,0185,0002,0005,0192,
01023, PORTO ACRE ,0001,1082,0608,0043,0008,0025,0155,0226,0180,0003,0000,0183,
01023, PORTO ACRE ,0001,1082,0609,0054,0006,0040,0128,0225,0168,0000,0003,0171,
01023, PORTO ACRE ,0001,1090,0610,0043,0005,0027,0150,0223,0177,0003,0000,0180,
01023, PORTO ACRE ,0001,1090,0611,0055,0008,0033,0126,0219,0159,0002,0003,0164,
01023, PORTO ACRE ,0001,1104,0612,0042,0018,0030,0155,0229,0185,0001,0001,0187,
01023, PORTO ACRE ,0001,1104,0613,0038,0010,0046,0145,0231,0191,0000,0002,0193,
01023, PORTO ACRE ,0001,1112,0614,0039,0005,0013,0130,0185,0143,0001,0002,0146,
01023, PORTO ACRE ,0001,1112,0615,0050,0000,0010,0119,0182,0129,0001,0002,0132,
01023, PORTO ACRE ,0001,1139,0616,0062,0023,0050,0181,0294,0231,0000,0001,0232,
01023, PORTO ACRE ,0001,1139,0617,0071,0004,0050,0170,0292,0220,0000,0001,0221,
01023, PORTO ACRE ,0001,1139,0618,0090,0005,0044,0152,0290,0196,0001,0003,0200,
01023, PORTO ACRE ,0001,1147,0619,0044,0010,0031,0116,0191,0147,0000,0000,0147,
01023, PORTO ACRE ,0001,1163,0620,0067,0003,0041,0119,0229,0160,0001,0001,0162,
01023, PORTO ACRE ,0001,1163,0621,0060,0014,0028,0146,0234,0174,0000,0000,0174,
01023, PORTO ACRE ,0001,1171,0622,0084,0007,0037,0121,0245,0158,0001,0002,0161,
01023, PORTO ACRE ,0001,1180,0623,0107,0007,0050,0118,0282,0168,0000,0007,0175,
01023, PORTO ACRE ,0001,1198,0624,0052,0014,0050,0148,0251,0198,0000,0001,0199,
01023, PORTO ACRE ,0001,1198,0625,0068,0012,0038,0137,0249,0175,0001,0005,0181,
01023, PORTO ACRE ,0001,1198,0626,0061,0003,0046,0136,0245,0182,0001,0001,0184,
01023, PORTO ACRE ,0001,1201,0627,0080,0014,0050,0207,0341,0257,0002,0002,0261,
01023, PORTO ACRE ,0001,1201,0628,0055,0011,0036,0136,0229,0172,0002,0000,0174,
01023, PORTO ACRE ,0001,1210,0630,0046,0033,0029,0145,0227,0174,0003,0004,0181,
01023, PORTO ACRE ,0001,1210,0631,0056,0016,0021,0115,0195,0136,0002,0001,0139,
01031, SANTA ROSA DO PURUS ,0003,1023,0058,0113,0024,0097,0105,0321,0202,0000,0006,0208,
01031, SANTA ROSA DO PURUS ,0003,1015,0060,0123,0012,0090,0118,0333,0208,0001,0001,0210,
01031, SANTA ROSA DO PURUS ,0003,1015,0065,0118,0010,0081,0120,0323,0201,0002,0002,0205,
01031, SANTA ROSA DO PURUS ,0003,1031,0072,0067,0022,0083,0099,0254,0182,0003,0002,0187,
01031, SANTA ROSA DO PURUS ,0003,1015,0076,0086,0019,0085,0117,0296,0202,0003,0005,0210,
01031, SANTA ROSA DO PURUS ,0003,1040,0077,0117,0009,0151,0025,0300,0176,0000,0007,0183,
01031, SANTA ROSA DO PURUS ,0003,1040,0087,0134,0014,0141,0031,0312,0172,0000,0006,0178,
01031, SANTA ROSA DO PURUS ,0003,1023,0088,0106,0008,0083,0110,0306,0193,0002,0005,0200,
01031, SANTA ROSA DO PURUS ,0003,1058,0095,0145,0015,0037,0149,0339,0186,0000,0008,0194,
01031, SANTA ROSA DO PURUS ,0003,1066,0096,0116,0017,0172,0028,0329,0200,0002,0011,0213,
01031, SANTA ROSA DO PURUS ,0003,1031,0122,0072,0005,0063,0085,0222,0148,0000,0002,0150,
01031, SANTA ROSA DO PURUS ,0003,1023,0125,0107,0010,0078,0091,0286,0169,0004,0006,0179,
01031, SANTA ROSA DO PURUS ,0003,1023,0152,0041,0003,0056,0049,0149,0105,0000,0003,0108,
01040, MARECHAL THAUMATURGO ,0004,1015,0073,0150,0021,0071,0133,0357,0204,0001,0002,0207,
01040, MARECHAL THAUMATURGO ,0004,1023,0074,0126,0037,0105,0100,0336,0205,0001,0004,0210,
01040, MARECHAL THAUMATURGO ,0004,1023,0075,0159,0039,0082,0106,0349,0188,0001,0001,0190,
01040, MARECHAL THAUMATURGO ,0004,1031,0076,0107,0015,0069,0087,0267,0156,0004,0000,0160,
01040, MARECHAL THAUMATURGO ,0004,1015,0114,0108,0027,0079,0124,0321,0203,0005,0005,0213,
01040, MARECHAL THAUMATURGO ,0004,1090,0140,0117,0020,0089,0105,0316,0194,0001,0004,0199,
01040, MARECHAL THAUMATURGO ,0004,1023,0141,0121,0026,0087,0106,0315,0193,0000,0001,0194,
01040, MARECHAL THAUMATURGO ,0004,1031,0142,0104,0037,0064,0086,0260,0150,0002,0004,0156,
01040, MARECHAL THAUMATURGO ,0004,1040,0143,0121,0053,0046,0154,0325,0200,0001,0003,0204,
01040, MARECHAL THAUMATURGO ,0004,1058,0160,0194,0014,0040,0063,0302,0103,0000,0005,0108,
01040, MARECHAL THAUMATURGO ,0004,1066,0161,0109,0017,0037,0136,0284,0173,0001,0001,0175,
01040, MARECHAL THAUMATURGO ,0004,1074,0162,0115,0018,0075,0079,0272,0154,0001,0002,0157,
01040, MARECHAL THAUMATURGO ,0004,1082,0163,0108,0040,0034,0132,0277,0166,0001,0002,0169,
01040, MARECHAL THAUMATURGO ,0004,1120,0182,0123,0023,0067,0028,0225,0095,0000,0007,0102,
01040, MARECHAL THAUMATURGO ,0004,1040,0196,0099,0015,0052,0144,0299,0196,0003,0001,0200,
01040, MARECHAL THAUMATURGO ,0004,1074,0201,0136,0024,0052,0082,0275,0134,0003,0002,0139,
01040, MARECHAL THAUMATURGO ,0004,1082,0203,0087,0038,0035,0141,0265,0176,0001,0001,0178,
01040, MARECHAL THAUMATURGO ,0004,1139,0223,0141,0024,0046,0076,0268,0122,0002,0003,0127,
01040, MARECHAL THAUMATURGO ,0004,1120,0230,0121,0022,0070,0029,0227,0099,0001,0006,0106,
01040, MARECHAL THAUMATURGO ,0004,1147,0236,0080,0027,0150,0006,0250,0156,0000,0014,0170,
01040, MARECHAL THAUMATURGO ,0004,1155,0237,0133,0034,0078,0039,0254,0117,0001,0003,0121,
01040, MARECHAL THAUMATURGO ,0004,1015,0251,0096,0020,0086,0115,0302,0201,0000,0005,0206,
01040, MARECHAL THAUMATURGO ,0004,1023,0279,0118,0040,0081,0105,0307,0186,0000,0003,0189,
01040, MARECHAL THAUMATURGO ,0004,1090,0284,0109,0016,0076,0121,0310,0197,0002,0002,0201,
01040, MARECHAL THAUMATURGO ,0004,1139,0294,0152,0031,0036,0075,0265,0111,0001,0001,0113,
01040, MARECHAL THAUMATURGO ,0004,1180,0318,0081,0031,0133,0103,0320,0236,0001,0002,0239,
01040, MARECHAL THAUMATURGO ,0004,1171,0324,0100,0007,0026,0082,0209,0108,0000,0001,0109,
01040, MARECHAL THAUMATURGO ,0004,1163,0326,0090,0051,0153,0250,0153,0001,0006,0160,
01040, MARECHAL THAUMATURGO ,0004,1031,0327,0086,0039,0055,0100,0245,0155,0002,0002,0159,
01040, MARECHAL THAUMATURGO ,0004,1015,0331,0116,0013,0064,0113,0297,0177,0002,0002,0181,
01040, MARECHAL THAUMATURGO ,0004,1040,0337,0087,0015,0041,0147,0280,0188,0001,0004,0193,
01040, MARECHAL THAUMATURGO ,0004,1031,0347,0096,0026,0054,0100,0259,0154,0002,0007,0163,
01040, MARECHAL THAUMATURGO ,0004,1023,0359,0127,0019,0061,0089,0281,0150,0002,0002,0154,
01040, MARECHAL THAUMATURGO ,0004,1066,0375,0134,0025,0039,0095,0270,0134,0001,0001,0136,
01040, MARECHAL THAUMATURGO ,0004,1147,0384,0080,0016,0101,0185,0101,0000,0004,0105,
01040, MARECHAL THAUMATURGO ,0004,1155,0389,0061,0010,0038,0009,0109,0047,0000,0001,0048,
01040, MARECHAL THAUMATURGO ,0004,1015,0424,0134,0006,0051,0106,0291,0157,0000,0000,0157,
01040, MARECHAL THAUMATURGO ,0004,1023,0434,0145,0013,0066,0081,0294,0147,0000,0002,0149,
01040, MARECHAL THAUMATURGO ,0004,1015,0435,0113,0011,0069,0109,0296,0178,0002,0003,0183,
01040, MARECHAL THAUMATURGO ,0004,1082,0441,0057,0013,0021,0056,0134,0077,0000,0000,0077,
01040, MARECHAL THAUMATURGO ,0004,1031,0443,0108,0014,0036,0082,0227,0118,0000,0001,0119,
01040, MARECHAL THAUMATURGO ,0004,1074,0444,0090,0010,0027,0066,0185,0093,0000,0002,0095,
01058, BRASILÉIA ,0006,2275,0001,0038,0007,0036,0107,0185,0143,0000,0004,0147,
01058, BRASILÉIA ,0006,2127,0002,0064,0017,0078,0141,0288,0219,0002,0003,0224,
01058, BRASILÉIA ,0006,2046,0003,0075,0017,0052,0130,0258,0182,0000,0001,0183,
01058, BRASILÉIA ,0006,1040,0004,0073,0014,0045,0155,0279,0200,0003,0003,0206,
01058, BRASILÉIA ,0006,1112,0005,0042,0010,0055,0118,0218,0173,0002,0001,0176,
01058, BRASILÉIA ,0006,1066,0006,0056,0012,0063,0147,0267,0210,0000,0001,0211,
01058, BRASILÉIA ,0006,1066,0007,0077,0022,0047,0144,0271,0191,0000,0003,0194,
01058, BRASILÉIA ,0006,1066,0008,0068,0012,0054,0144,0270,0198,0000,0004,0202,
01058, BRASILÉIA ,0006,1082,0011,0068,0015,0064,0136,0279,0200,0001,0010,0211,
01058, BRASILÉIA ,0006,1082,0013,0068,0014,0069,0133,0274,0202,0000,0004,0206,
01058, BRASILÉIA ,0006,1082,0014,0072,0009,0073,0124,0273,0197,0002,0002,0201,
01058, BRASILÉIA ,0006,1104,0016,0040,0013,0042,0105,0190,0147,0001,0002,0150,
01058, BRASILÉIA ,0006,1104,0017,0041,0011,0039,0109,0191,0148,0001,0001,0150,
01058, BRASILÉIA ,0006,1104,0018,0051,0002,0039,0100,0194,0139,0002,0002,0143,
01058, BRASILÉIA ,0006,1112,0019,0070,0008,0053,0195,0322,0248,0001,0003,0252,
01058, BRASILÉIA ,0006,2127,0020,0073,0015,0071,0140,0289,0211,0002,0003,0216,
01058, BRASILÉIA ,0006,2313,0021,0069,0011,0057,0140,0270,0197,0001,0003,0201,
01058, BRASILÉIA ,0006,2313,0023,0068,0018,0052,0144,0267,0196,0001,0002,0199,
01058, BRASILÉIA ,0006,2046,0024,0065,0011,0053,0139,0258,0192,0000,0001,0193,
01058, BRASILÉIA ,0006,1180,0025,0070,0015,0070,0135,0275,0205,0000,0000,0205,
01058, BRASILÉIA ,0006,1066,0032,0055,0020,0053,0160,0270,0213,0002,0000,0215,
01058, BRASILÉIA ,0006,2046,0035,0064,0015,0059,0137,0267,0196,0003,0004,0203,
01058, BRASILÉIA ,0006,1082,0038,0028,0006,0040,0073,0142,0113,0001,0000,0114,
01058, BRASILÉIA ,0006,1996,0039,0076,0008,0072,0140,0296,0212,0005,0003,0220,
01058, BRASILÉIA ,0006,1066,0041,0062,0012,0049,0150,0263,0199,0001,0001,0201,
01058, BRASILÉIA ,0006,1066,0044,0066,0014,0054,0142,0264,0196,0001,0001,0198,
01058, BRASILÉIA ,0006,1040,0045,0059,0010,0073,0152,0287,0225,0002,0001,0228,
01058, BRASILÉIA ,0006,1074,0053,0047,0013,0034,0160,0242,0194,0001,0000,0195,
01058, BRASILÉIA ,0006,2305,0054,0043,0011,0096,0070,0211,0166,0001,0001,0168,
01058, BRASILÉIA ,0006,1198,0055,0097,0008,0057,0173,0329,0230,0001,0001,0232,
01058, BRASILÉIA ,0006,1198,0056,0049,0011,0040,0112,0203,0152,0001,0001,0154,
01058, BRASILÉIA ,0006,1180,0057,0047,0003,0042,0120,0213,0162,0002,0002,0166,
01058, BRASILÉIA ,0006,2313,0058,0063,0007,0053,0145,0263,0198,0000,0002,0200,
01058, BRASILÉIA ,0006,1210,0062,0052,0015,0052,0170,0278,0222,0001,0003,0226,
01058, BRASILÉIA ,0006,1228,0063,0070,0005,0057,0102,0234,0159,0001,0004,0164,
01058, BRASILÉIA ,0006,1210,0067,0064,0018,0053,0154,0277,0207,0002,0004,0213,
01058, BRASILÉIA ,0006,1120,0074,0050,0025,0069,0163,0282,0232,0000,0000,0232,
01058, BRASILÉIA ,0006,1228,0075,0048,0008,0065,0113,0233,0178,0003,0004,0185,
01058, BRASILÉIA ,0006,1210,0076,0056,0017,0050,0168,0275,0218,0000,0001,0219,
01058, BRASILÉIA ,0006,1210,0080,0065,0015,0055,0158,0283,0213,0002,0003,0218,
01058, BRASILÉIA ,0006,1120,0081,0052,0019,0071,0159,0286,0230,0003,0001,0234,
01058, BRASILÉIA ,0006,1210,0083,0063,0003,0052,0156,0276,0208,0002,0003,0213,
01058, BRASILÉIA ,0006,2275,0084,0050,0012,0032,0092,0176,0124,0001,0001,0126,
01058, BRASILÉIA ,0006,1228,0085,0069,0009,0060,0097,0230,0157,0003,0001,0161,
01058, BRASILÉIA ,0006,1120,0087,0073,0006,0062,0140,0277,0202,0000,0002,0204,
01058, BRASILÉIA ,0006,1023,0088,0077,0005,0063,0166,0313,0229,0003,0004,0236,
01058, BRASILÉIA ,0006,1210,0089,0082,0005,0046,0154,0284,0200,0001,0001,0202,
01058, BRASILÉIA ,0006,1120,0091,0066,0013,0057,0156,0285,0213,0003,0003,0219,
01058, BRASILÉIA ,0006,2127,0094,0048,0007,0052,0175,0278,0227,0001,0002,0230,
01058, BRASILÉIA ,0006,1074,0099,0077,0013,0036,0155,0269,0191,0000,0001,0192,
01058, BRASILÉIA ,0006,2151,0100,0078,0024,0052,0105,0238,0157,0002,0001,0160,
01058, BRASILÉIA ,0006,2291,0102,0057,0004,0062,0120,0241,0182,0001,0001,0184,
01058, BRASILÉIA ,0006,1198,0112,0092,0022,0052,0189,0337,0241,0002,0002,0245,
01058, BRASILÉIA ,0006,2208,0113,0029,0011,0080,0100,0215,0180,0005,0001,0186,
01058, BRASILÉIA ,0006,2224,0117,0086,0004,0043,0055,0187,0098,0000,0003,0101,
01058, BRASILÉIA ,0006,1120,0118,0074,0018,0052,0158,0284,0210,0000,0000,0210,
01058, BRASILÉIA ,0006,1180,0119,0073,0016,0069,0134,0278,0203,0000,0002,0205,
01058, BRASILÉIA ,0006,2313,0120,0079,0001,0045,0150,0278,0195,0001,0003,0199,
01058, BRASILÉIA ,0006,1228,0121,0062,0006,0066,0101,0233,0167,0001,0003,0171,
01058, BRASILÉIA ,0006,2267,0122,0077,0023,0078,0135,0294,0213,0003,0001,0217,
01058, BRASILÉIA ,0006,1040,0126,0050,0004,0078,0156,0288,0234,0003,0001,0238,
01058, BRASILÉIA ,0006,1074,0128,0053,0009,0018,0173,0244,0191,0000,0000,0191,
01058, BRASILÉIA ,0006,1996,0131,0057,0005,0085,0165,0312,0250,0003,0002,0255,
01058, BRASILÉIA ,0006,2240,0132,0058,0001,0064,0039,0162,0103,0001,0000,0104,
01058, BRASILÉIA ,0006,1040,0133,0062,0014,0059,0160,0287,0219,0003,0003,0225,
01058, BRASILÉIA ,0006,1996,0136,0077,0010,0056,0151,0286,0207,0002,0000,0209,
01058, BRASILÉIA ,0006,1040,0138,0067,0007,0068,0143,0285,0211,0001,0006,0218,
01058, BRASILÉIA ,0006,1040,0139,0069,0016,0050,0159,0284,0209,0001,0005,0215,
01058, BRASILÉIA ,0006,2151,0140,0048,0002,0017,0060,0127,0077,0000,0002,0079,
01058, BRASILÉIA ,0006,2283,0146,0033,0004,0032,0075,0142,0107,0001,0001,0109,
01058, BRASILÉIA ,0006,1120,0152,0055,0007,0066,0167,0291,0233,0003,0000,0236,
01066, PORTO WALTER ,0004,1031,0077,0132,0025,0085,0089,0312,0174,0003,0003,0180,
01066, PORTO WALTER ,0004,1023,0078,0119,0034,0099,0087,0314,0186,0004,0005,0195,
01066, PORTO WALTER ,0004,1023,0079,0126,0022,0079,0095,0305,0174,0002,0003,0179,
01066, PORTO WALTER ,0004,1040,0080,0120,0033,0089,0103,0320,0192,0003,0005,0200,
01066, PORTO WALTER ,0004,1031,0115,0107,0020,0102,0090,0306,0192,0001,0006,0199,
01066, PORTO WALTER ,0004,1015,0132,0140,0032,0087,0084,0317,0171,0001,0005,0177,
01066, PORTO WALTER ,0004,1023,0144,0095,0038,0094,0102,0298,0196,0007,0000,0203,
01066, PORTO WALTER ,0004,1031,0145,0128,0038,0086,0093,0312,0179,0003,0002,0184,
01066, PORTO WALTER ,0004,1040,0146,0119,0018,0088,0096,0308,0184,0001,0004,0189,
01066, PORTO WALTER ,0004,1058,0164,0097,0036,0086,0069,0260,0155,0005,0003,0163,
01066, PORTO WALTER ,0004,1074,0166,0145,0020,0052,0057,0259,0109,0000,0005,0114,
01066, PORTO WALTER ,0004,1058,0245,0114,0015,0085,0056,0263,0141,0005,0003,0149,
01066, PORTO WALTER ,0004,1090,0311,0125,0021,0162,0024,0318,0186,0002,0005,0193,
01066, PORTO WALTER ,0004,1139,0313,0051,0011,0053,0014,0122,0067,0000,0004,0071,
01066, PORTO WALTER ,0004,1082,0314,0053,0010,0060,0013,0129,0073,0002,0001,0076,
01066, PORTO WALTER ,0004,1120,0316,0120,0020,0109,0066,0301,0175,0004,0002,0181,
01066, PORTO WALTER ,0004,1104,0320,0091,0029,0034,0098,0228,0132,0002,0003,0137,
01066, PORTO WALTER ,0004,1112,0321,0048,0002,0072,0006,0126,0078,0000,0000,0078,
01066, PORTO WALTER ,0004,1147,0325,0092,0006,0043,0086,0221,0129,0000,0000,0129,
01066, PORTO WALTER ,0004,1023,0338,0135,0034,0077,0082,0302,0159,0002,0006,0167,
01066, PORTO WALTER ,0004,1031,0361,0170,0017,0062,0048,0287,0110,0005,0002,0117,
01066, PORTO WALTER ,0004,1040,0372,0130,0025,0079,0073,0287,0152,0003,0002,0157,
01066, PORTO WALTER ,0004,1015,0373,0139,0032,0083,0068,0293,0151,0001,0002,0154,
01066, PORTO WALTER ,0004,1104,0429,0082,0019,0025,0056,0164,0081,0001,0000,0082,
01066, PORTO WALTER ,0004,1040,0430,0156,0018,0066,0066,0292,0132,0002,0002,0136,
01066, PORTO WALTER ,0004,1040,0442,0148,0025,0051,0093,0296,0144,0002,0002,0148,
01066, PORTO WALTER ,0004,1015,0447,0151,0009,0085,0052,0294,0137,0004,0002,0143,
01074, CRUZEIRO DO SUL ,0004,1015,0001,0086,0033,0060,0159,0312,0219,0002,0005,0226,
01074, CRUZEIRO DO SUL ,0004,1015,0005,0074,0037,0044,0162,0285,0206,0001,0004,0211,
01074, CRUZEIRO DO SUL ,0004,1058,0007,0068,0032,0031,0136,0240,0167,0001,0004,0172,
01074, CRUZEIRO DO SUL ,0004,1066,0008,0071,0024,0041,0133,0247,0174,0001,0001,0176,
01074, CRUZEIRO DO SUL ,0004,1074,0009,0055,0032,0046,0107,0211,0153,0000,0003,0156,
01074, CRUZEIRO DO SUL ,0004,1074,0010,0055,0038,0042,0113,0214,0155,0003,0001,0159,
01074, CRUZEIRO DO SUL ,0004,1074,0011,0067,0032,0043,0128,0243,0171,0002,0003,0176,
01074, CRUZEIRO DO SUL ,0004,1104,0013,0054,0020,0032,0097,0188,0129,0001,0004,0134,
01074, CRUZEIRO DO SUL ,0004,1104,0014,0060,0012,0027,0096,0188,0123,0002,0003,0128,
01074, CRUZEIRO DO SUL ,0004,1015,0015,0071,0045,0063,0185,0331,0248,0008,0004,0260,
01074, CRUZEIRO DO SUL ,0004,1066,0016,0067,0019,0039,0138,0247,0177,0002,0001,0180,
01074, CRUZEIRO DO SUL ,0004,1147,0017,0055,0018,0055,0158,0272,0213,0003,0001,0217,
01074, CRUZEIRO DO SUL ,0004,1120,0019,0088,0039,0034,0161,0287,0195,0002,0002,0199,
01074, CRUZEIRO DO SUL ,0004,1147,0023,0068,0022,0049,0154,0276,0203,0004,0001,0208,
01074, CRUZEIRO DO SUL ,0004,1120,0025,0083,0036,0043,0151,0282,0194,0003,0002,0199,
01074, CRUZEIRO DO SUL ,0004,1066,0027,0068,0035,0038,0134,0246,0172,0003,0003,0178,
01074, CRUZEIRO DO SUL ,0004,1350,0038,0056,0030,0044,0155,0259,0199,0003,0001,0203,
01074, CRUZEIRO DO SUL ,0004,1350,0039,0068,0026,0052,0144,0271,0196,0002,0005,0203,
01074, CRUZEIRO DO SUL ,0004,1350,0040,0057,0051,0060,0143,0265,0203,0002,0003,0208,
01074, CRUZEIRO DO SUL ,0004,1368,0041,0028,0029,0047,0123,0201,0170,0002,0001,0173,
01074, CRUZEIRO DO SUL ,0004,1376,0042,0045,0027,0032,0114,0193,0146,0002,0000,0148,
01074, CRUZEIRO DO SUL ,0004,1376,0043,0046,0020,0026,0123,0198,0149,0001,0002,0152,
01074, CRUZEIRO DO SUL ,0004,1384,0044,0062,0022,0051,0137,0251,0188,0000,0001,0189,
01074, CRUZEIRO DO SUL ,0004,1392,0045,0053,0046,0058,0140,0264,0198,0006,0007,0211,
01074, CRUZEIRO DO SUL ,0004,1406,0046,0063,0039,0047,0174,0285,0221,0001,0000,0222,
01074, CRUZEIRO DO SUL ,0004,1406,0047,0071,0025,0042,0175,0290,0217,0002,0000,0219,
01074, CRUZEIRO DO SUL ,0004,1406,0048,0073,0024,0044,0161,0279,0205,0000,0001,0206,
01074, CRUZEIRO DO SUL ,0004,1422,0049,0060,0023,0052,0159,0277,0211,0003,0003,0217,
01074, CRUZEIRO DO SUL ,0004,1422,0051,0053,0044,0037,0188,0283,0225,0001,0004,0230,
01074, CRUZEIRO DO SUL ,0004,1520,0055,0048,0025,0035,0133,0220,0168,0002,0002,0172,
01074, CRUZEIRO DO SUL ,0004,1520,0056,0050,0018,0036,0137,0228,0173,0002,0003,0178,
01074, CRUZEIRO DO SUL ,0004,1554,0057,0067,0038,0058,0149,0283,0207,0006,0003,0216,
01074, CRUZEIRO DO SUL ,0004,1554,0058,0083,0028,0045,0159,0290,0204,0002,0001,0207,
01074, CRUZEIRO DO SUL ,0004,1473,0059,0029,0031,0025,0121,0177,0146,0002,0000,0148,
01074, CRUZEIRO DO SUL ,0004,1570,0060,0049,0029,0041,0148,0241,0189,0003,0000,0192,
01074, CRUZEIRO DO SUL ,0004,1570,0061,0057,0034,0032,0135,0233,0167,0004,0005,0176,
01074, CRUZEIRO DO SUL ,0004,1520,0062,0051,0030,0040,0126,0220,0166,0002,0001,0169,
01074, CRUZEIRO DO SUL ,0004,1600,0063,0074,0029,0036,0073,0188,0109,0002,0003,0114,
01074, CRUZEIRO DO SUL ,0004,1600,0064,0063,0020,0029,0094,0189,0123,0000,0003,0126,
01074, CRUZEIRO DO SUL ,0004,1619,0065,0042,0016,0041,0104,0192,0145,0003,0002,0150,
01074, CRUZEIRO DO SUL ,0004,1619,0066,0040,0020,0040,0097,0181,0137,0003,0001,0141,
01074, CRUZEIRO DO SUL ,0004,1619,0067,0051,0024,0037,0096,0190,0133,0002,0004,0139,
01074, CRUZEIRO DO SUL ,0004,1350,0068,0068,0021,0049,0139,0262,0188,0003,0003,0194,
01074, CRUZEIRO DO SUL ,0004,1066,0069,0068,0024,0044,0129,0246,0173,0002,0003,0178,
01074, CRUZEIRO DO SUL ,0004,1643,0070,0105,0027,0054,0127,0291,0181,0003,0002,0186,
01074, CRUZEIRO DO SUL ,0004,1031,0085,0062,0016,0049,0149,0262,0198,0001,0001,0200,
01074, CRUZEIRO DO SUL ,0004,1031,0086,0073,0021,0037,0141,0257,0178,0002,0004,0184,
01074, CRUZEIRO DO SUL ,0004,1783,0087,0056,0029,0036,0168,0262,0204,0002,0000,0206,
01074, CRUZEIRO DO SUL ,0004,1791,0088,0069,0058,0029,0193,0297,0222,0002,0004,0228,
01074, CRUZEIRO DO SUL ,0004,1058,0107,0020,0016,0026,0102,0151,0128,0001,0002,0131,
01074, CRUZEIRO DO SUL ,0004,1155,0108,0072,0024,0042,0161,0286,0203,0002,0009,0214,
01074, CRUZEIRO DO SUL ,0004,1520,0110,0051,0018,0040,0125,0221,0165,0001,0004,0170,
01074, CRUZEIRO DO SUL ,0004,1457,0111,0071,0026,0045,0154,0275,0199,0002,0003,0204,
01074, CRUZEIRO DO SUL ,0004,1473,0112,0027,0008,0029,0100,0162,0129,0003,0003,0135,
01074, CRUZEIRO DO SUL ,0004,1600,0113,0057,0026,0022,0095,0183,0117,0003,0006,0126,
01074, CRUZEIRO DO SUL ,0004,1066,0117,0069,0013,0037,0133,0245,0170,0004,0002,0176,
01074, CRUZEIRO DO SUL ,0004,1120,0118,0076,0021,0038,0164,0283,0202,0002,0003,0207,
01074, CRUZEIRO DO SUL ,0004,1597,0120,0069,0037,0046,0157,0278,0203,0005,0001,0209,
01074, CRUZEIRO DO SUL ,0004,1155,0121,0073,0029,0050,0161,0291,0211,0001,0006,0218,
01074, CRUZEIRO DO SUL ,0004,1155,0123,0071,0024,0041,0164,0281,0205,0004,0001,0210,
01074, CRUZEIRO DO SUL ,0004,1619,0125,0048,0019,0036,0100,0188,0136,0001,0003,0140,
01074, CRUZEIRO DO SUL ,0004,1066,0126,0063,0021,0040,0135,0246,0175,0000,0008,0183,
01074, CRUZEIRO DO SUL ,0004,1368,0130,0033,0016,0039,0119,0193,0158,0001,0001,0160,
01074, CRUZEIRO DO SUL ,0004,2089,0131,0118,0013,0029,0084,0232,0113,0001,0000,0114,
01074, CRUZEIRO DO SUL ,0004,1031,0135,0075,0029,0042,0139,0263,0181,0000,0007,0188,
01074, CRUZEIRO DO SUL ,0004,1791,0136,0060,0024,0038,0187,0291,0225,0005,0001,0231,
01074, CRUZEIRO DO SUL ,0004,2089,0137,0128,0020,0011,0090,0231,0101,0000,0002,0103,
01074, CRUZEIRO DO SUL ,0004,2097,0138,0078,0014,0022,0149,0253,0171,0002,0002,0175,
01074, CRUZEIRO DO SUL ,0004,2100,0139,0054,0021,0042,0159,0260,0201,0003,0002,0206,
01074, CRUZEIRO DO SUL ,0004,1783,0152,0061,0036,0035,0166,0265,0201,0001,0002,0204,
01074, CRUZEIRO DO SUL ,0004,1309,0154,0051,0031,0047,0151,0253,0198,0002,0002,0202,
01074, CRUZEIRO DO SUL ,0004,2127,0155,0062,0040,0065,0151,0283,0216,0001,0004,0221,
01074, CRUZEIRO DO SUL ,0004,2135,0156,0067,0024,0046,0165,0285,0211,0002,0005,0218,
01074, CRUZEIRO DO SUL ,0004,2143,0157,0065,0013,0064,0151,0283,0215,0001,0002,0218,
01074, CRUZEIRO DO SUL ,0004,2160,0158,0067,0037,0034,0171,0275,0205,0001,0002,0208,
01074, CRUZEIRO DO SUL ,0004,2151,0159,0044,0029,0038,0150,0236,0188,0002,0002,0192,
01074, CRUZEIRO DO SUL ,0004,2224,0165,0086,0016,0017,0150,0254,0167,0000,0001,0168,
01074, CRUZEIRO DO SUL ,0004,2089,0167,0116,0007,0030,0086,0234,0116,0000,0002,0118,
01074, CRUZEIRO DO SUL ,0004,1309,0168,0053,0035,0032,0164,0255,0196,0004,0002,0202,
01074, CRUZEIRO DO SUL ,0004,1392,0173,0038,0039,0051,0165,0262,0216,0006,0002,0224,
01074, CRUZEIRO DO SUL ,0004,2143,0175,0072,0043,0051,0157,0288,0208,0002,0006,0216,
01074, CRUZEIRO DO SUL ,0004,1643,0178,0099,0010,0041,0143,0290,0184,0003,0004,0191,
01074, CRUZEIRO DO SUL ,0004,1309,0179,0048,0029,0051,0156,0255,0207,0000,0000,0207,
01074, CRUZEIRO DO SUL ,0004,1457,0183,0050,0057,0053,0153,0263,0206,0005,0002,0213,
01074, CRUZEIRO DO SUL ,0004,2100,0184,0061,0034,0046,0157,0268,0203,0002,0002,0207,
01074, CRUZEIRO DO SUL ,0004,2097,0185,0067,0028,0039,0143,0255,0182,0002,0004,0188,
01074, CRUZEIRO DO SUL ,0004,1155,0187,0068,0029,0051,0155,0278,0206,0001,0003,0210,
01074, CRUZEIRO DO SUL ,0004,2127,0188,0072,0029,0040,0162,0276,0202,0000,0002,0204,
01074, CRUZEIRO DO SUL ,0004,1171,0189,0047,0033,0037,0152,0241,0189,0000,0005,0194,
01074, CRUZEIRO DO SUL ,0004,1783,0191,0059,0024,0031,0152,0257,0183,0008,0007,0198,
01074, CRUZEIRO DO SUL ,0004,1325,0192,0059,0014,0018,0099,0176,0117,0000,0000,0117,
01074, CRUZEIRO DO SUL ,0004,1392,0194,0047,0031,0048,0153,0256,0201,0003,0005,0209,
01074, CRUZEIRO DO SUL ,0004,1384,0195,0061,0027,0039,0152,0253,0191,0001,0000,0192,
01074, CRUZEIRO DO SUL ,0004,2135,0198,0059,0018,0052,0166,0287,0218,0002,0008,0228,
01074, CRUZEIRO DO SUL ,0004,1228,0199,0057,0027,0045,0130,0237,0175,0003,0002,0180,
01074, CRUZEIRO DO SUL ,0004,1066,0200,0056,0016,0047,0137,0245,0184,0002,0003,0189,
01074, CRUZEIRO DO SUL ,0004,1791,0204,0054,0030,0043,0195,0296,0238,0004,0000,0242,
01074, CRUZEIRO DO SUL ,0004,1325,0205,0049,0013,0021,0102,0175,0123,0001,0002,0126,
01074, CRUZEIRO DO SUL ,0004,1295,0206,0073,0045,0035,0178,0287,0213,0001,0000,0214,
01074, CRUZEIRO DO SUL ,0004,1198,0207,0058,0020,0037,0156,0255,0193,0001,0003,0197,
01074, CRUZEIRO DO SUL ,0004,1031,0208,0067,0027,0047,0141,0258,0188,0002,0001,0191,
01074, CRUZEIRO DO SUL ,0004,1422,0210,0054,0024,0048,0165,0271,0213,0001,0003,0217,
01074, CRUZEIRO DO SUL ,0004,1210,0211,0060,0033,0041,0151,0255,0192,0002,0001,0195,
01074, CRUZEIRO DO SUL ,0004,2160,0213,0051,0042,0043,0174,0273,0217,0002,0003,0222,
01074, CRUZEIRO DO SUL ,0004,1597,0214,0068,0028,0051,0156,0280,0207,0002,0003,0212,
01074, CRUZEIRO DO SUL ,0004,1384,0219,0056,0030,0043,0151,0255,0194,0002,0003,0199,
01074, CRUZEIRO DO SUL ,0004,1309,0222,0053,0030,0053,0139,0250,0192,0001,0004,0197,
01074, CRUZEIRO DO SUL ,0004,2100,0224,0053,0021,0029,0111,0199,0140,0003,0003,0146,
01074, CRUZEIRO DO SUL ,0004,2186,0227,0072,0035,0049,0114,0239,0163,0002,0002,0167,
01074, CRUZEIRO DO SUL ,0004,2208,0228,0104,0028,0053,0120,0279,0173,0000,0002,0175,
01074, CRUZEIRO DO SUL ,0004,2194,0229,0084,0009,0037,0036,0159,0073,0000,0002,0075,
01074, CRUZEIRO DO SUL ,0004,2216,0235,0126,0006,0010,0063,0201,0073,0000,0002,0075,
01074, CRUZEIRO DO SUL ,0004,1228,0238,0063,0028,0031,0142,0239,0173,0002,0001,0176,
01074, CRUZEIRO DO SUL ,0004,1295,0239,0075,0037,0040,0161,0284,0201,0004,0004,0209,
01074, CRUZEIRO DO SUL ,0004,1554,0240,0070,0024,0045,0161,0282,0206,0003,0003,0212,
01074, CRUZEIRO DO SUL ,0004,1155,0242,0064,0023,0047,0163,0288,0210,0006,0008,0224,
01074, CRUZEIRO DO SUL ,0004,1473,0243,0032,0018,0025,0113,0176,0138,0004,0002,0144,
01074, CRUZEIRO DO SUL ,0004,2208,0244,0115,0030,0034,0131,0284,0165,0001,0003,0169,
01074, CRUZEIRO DO SUL ,0004,1155,0246,0063,0028,0045,0154,0270,0199,0004,0004,0207,
01074, CRUZEIRO DO SUL ,0004,1171,0247,0059,0022,0036,0147,0251,0183,0005,0004,0192,
01074, CRUZEIRO DO SUL ,0004,1120,0249,0078,0049,0048,0169,0302,0217,0003,0004,0224,
01074, CRUZEIRO DO SUL ,0004,1384,0252,0052,0024,0038,0157,0248,0195,0001,0000,0196,
01074, CRUZEIRO DO SUL ,0004,2127,0253,0072,0023,0050,0147,0278,0197,0004,0005,0206,
01074, CRUZEIRO DO SUL ,0004,2143,0254,0080,0021,0040,0154,0279,0194,0002,0003,0199,
01074, CRUZEIRO DO SUL ,0004,1392,0255,0050,0022,0045,0155,0257,0200,0002,0005,0207,
01074, CRUZEIRO DO SUL ,0004,2135,0256,0066,0032,0048,0168,0287,0216,0001,0004,0221,
01074, CRUZEIRO DO SUL ,0004,1481,0257,0067,0026,0041,0165,0280,0206,0002,0005,0213,
01074, CRUZEIRO DO SUL ,0004,1023,0258,0074,0017,0039,0132,0252,0171,0003,0004,0178,
01074, CRUZEIRO DO SUL ,0004,1457,0259,0056,0020,0045,0164,0270,0209,0005,0000,0214,
01074, CRUZEIRO DO SUL ,0004,1643,0260,0097,0031,0055,0121,0280,0176,0003,0004,0183,
01074, CRUZEIRO DO SUL ,0004,2100,0261,0061,0017,0052,0151,0266,0203,0002,0000,0205,
01074, CRUZEIRO DO SUL ,0004,1295,0262,0070,0030,0040,0173,0285,0213,0000,0002,0215,
01074, CRUZEIRO DO SUL ,0004,2089,0263,0130,0010,0024,0116,0271,0140,0000,0001,0141,
01074, CRUZEIRO DO SUL ,0004,1333,0266,0131,0029,0087,0094,0320,0181,0002,0006,0189,
01074, CRUZEIRO DO SUL ,0004,1228,0268,0051,0031,0037,0151,0240,0188,0001,0000,0189,
01074, CRUZEIRO DO SUL ,0004,1210,0269,0057,0028,0032,0162,0257,0194,0002,0004,0200,
01074, CRUZEIRO DO SUL ,0004,2194,0270,0094,0013,0030,0039,0164,0069,0000,0001,0070,
01074, CRUZEIRO DO SUL ,0004,2232,0271,0070,0027,0064,0156,0294,0220,0003,0001,0224,
01074, CRUZEIRO DO SUL ,0004,2240,0275,0093,0027,0082,0133,0314,0215,0001,0005,0221,
01074, CRUZEIRO DO SUL ,0004,2151,0278,0074,0028,0038,0124,0238,0162,0002,0000,0164,
01074, CRUZEIRO DO SUL ,0004,2259,0280,0146,0048,0072,0079,0306,0151,0002,0007,0160,
01074, CRUZEIRO DO SUL ,0004,1791,0282,0062,0029,0029,0187,0286,0216,0004,0004,0224,
01074, CRUZEIRO DO SUL ,0004,2224,0285,0098,0018,0019,0139,0257,0158,0000,0001,0159,
01074, CRUZEIRO DO SUL ,0004,1155,0287,0072,0037,0040,0162,0284,0202,0007,0003,0212,
01074, CRUZEIRO DO SUL ,0004,1406,0288,0073,0029,0043,0163,0280,0206,0000,0001,0207,
01074, CRUZEIRO DO SUL ,0004,2267,0291,0152,0019,0026,0109,0291,0135,0000,0004,0139,
01074, CRUZEIRO DO SUL ,0004,2275,0293,0084,0016,0043,0166,0297,0209,0000,0004,0213,
01074, CRUZEIRO DO SUL ,0004,2160,0295,0069,0021,0034,0168,0275,0202,0004,0000,0206,
01074, CRUZEIRO DO SUL ,0004,2259,0296,0164,0027,0065,0076,0310,0141,0000,0005,0146,
01074, CRUZEIRO DO SUL ,0004,1333,0297,0128,0036,0072,0112,0317,0184,0000,0005,0189,
01074, CRUZEIRO DO SUL ,0004,1600,0300,0068,0009,0019,0064,0157,0083,0001,0005,0089,
01074, CRUZEIRO DO SUL ,0004,2291,0301,0086,0014,0227,0002,0325,0229,0000,0010,0239,
01074, CRUZEIRO DO SUL ,0004,2305,0305,0070,0019,0063,0150,0285,0213,0000,0002,0215,
01074, CRUZEIRO DO SUL ,0004,2321,0306,0038,0006,0016,0082,0136,0098,0000,0000,0098,
01074, CRUZEIRO DO SUL ,0004,2313,0308,0070,0017,0013,0126,0213,0139,0002,0002,0143,
01074, CRUZEIRO DO SUL ,0004,2348,0312,0082,0019,0048,0165,0299,0213,0003,0001,0217,
01074, CRUZEIRO DO SUL ,0004,1481,0315,0064,0029,0056,0161,0288,0217,0003,0004,0224,
01074, CRUZEIRO DO SUL ,0004,2330,0319,0072,0023,0031,0115,0222,0146,0001,0003,0150,
01074, CRUZEIRO DO SUL ,0004,1392,0322,0066,0027,0050,0143,0265,0193,0002,0004,0199,
01074, CRUZEIRO DO SUL ,0004,1554,0323,0066,0028,0054,0162,0284,0216,0001,0001,0218,
01074, CRUZEIRO DO SUL ,0004,1228,0328,0060,0025,0041,0135,0239,0176,0003,0000,0179,
01074, CRUZEIRO DO SUL ,0004,2356,0329,0094,0048,0066,0117,0283,0183,0003,0003,0189,
01074, CRUZEIRO DO SUL ,0004,1295,0330,0077,0030,0052,0147,0286,0199,0005,0005,0209,
01074, CRUZEIRO DO SUL ,0004,2240,0332,0109,0023,0045,0111,0267,0156,0000,0002,0158,
01074, CRUZEIRO DO SUL ,0004,1198,0333,0083,0019,0028,0139,0256,0167,0003,0003,0173,
01074, CRUZEIRO DO SUL ,0004,2232,0334,0058,0035,0057,0179,0299,0236,0003,0002,0241,
01074, CRUZEIRO DO SUL ,0004,1481,0336,0074,0032,0052,0152,0285,0204,0004,0003,0211,
01074, CRUZEIRO DO SUL ,0004,1643,0339,0111,0022,0040,0133,0288,0173,0000,0004,0177,
01074, CRUZEIRO DO SUL ,0004,1171,0340,0070,0033,0043,0136,0255,0179,0003,0003,0185,
01074, CRUZEIRO DO SUL ,0004,1597,0341,0077,0032,0048,0161,0289,0209,0001,0002,0212,
01074, CRUZEIRO DO SUL ,0004,2143,0342,0072,0010,0058,0151,0287,0209,0003,0003,0215,
01074, CRUZEIRO DO SUL ,0004,1791,0343,0072,0036,0032,0174,0287,0206,0005,0004,0215,
01074, CRUZEIRO DO SUL ,0004,1384,0345,0072,0016,0038,0141,0256,0179,0001,0004,0184,
01074, CRUZEIRO DO SUL ,0004,2186,0348,0076,0017,0026,0139,0242,0165,0001,0000,0166,
01074, CRUZEIRO DO SUL ,0004,1295,0350,0076,0034,0039,0165,0289,0204,0006,0003,0213,
01074, CRUZEIRO DO SUL ,0004,2097,0352,0097,0017,0032,0125,0255,0157,0000,0001,0158,
01074, CRUZEIRO DO SUL ,0004,1570,0353,0064,0017,0042,0134,0242,0176,0002,0000,0178,
01074, CRUZEIRO DO SUL ,0004,1457,0354,0075,0023,0037,0160,0282,0197,0007,0003,0207,
01074, CRUZEIRO DO SUL ,0004,1422,0355,0062,0024,0047,0167,0283,0214,0003,0004,0221,
01074, CRUZEIRO DO SUL ,0004,1155,0356,0099,0028,0046,0134,0287,0180,0001,0007,0188,
01074, CRUZEIRO DO SUL ,0004,1392,0358,0065,0026,0043,0149,0265,0192,0006,0002,0200,
01074, CRUZEIRO DO SUL ,0004,1350,0360,0071,0016,0047,0147,0268,0194,0002,0001,0197,
01074, CRUZEIRO DO SUL ,0004,2160,0362,0072,0026,0041,0164,0281,0205,0001,0003,0209,
01074, CRUZEIRO DO SUL ,0004,2208,0363,0123,0026,0042,0118,0284,0160,0001,0000,0161,
01074, CRUZEIRO DO SUL ,0004,2127,0365,0075,0032,0055,0145,0281,0200,0001,0005,0206,
01074, CRUZEIRO DO SUL ,0004,1783,0370,0079,0025,0029,0146,0260,0175,0004,0002,0181,
01074, CRUZEIRO DO SUL ,0004,1473,0374,0033,0024,0037,0095,0170,0132,0001,0004,0137,
01074, CRUZEIRO DO SUL ,0004,1554,0376,0068,0040,0052,0163,0291,0215,0002,0006,0223,
01074, CRUZEIRO DO SUL ,0004,1155,0378,0086,0021,0053,0150,0293,0203,0003,0001,0207,
01074, CRUZEIRO DO SUL ,0004,2151,0379,0065,0035,0040,0126,0236,0166,0002,0003,0171,
01074, CRUZEIRO DO SUL ,0004,1333,0382,0162,0011,0061,0091,0317,0152,0000,0003,0155,
01074, CRUZEIRO DO SUL ,0004,1295,0383,0090,0035,0036,0161,0295,0197,0003,0005,0205,
01074, CRUZEIRO DO SUL ,0004,1031,0385,0104,0019,0034,0121,0260,0155,0001,0000,0156,
01074, CRUZEIRO DO SUL ,0004,1023,0386,0089,0027,0026,0134,0254,0160,0001,0004,0165,
01074, CRUZEIRO DO SUL ,0004,1228,0390,0071,0030,0039,0138,0255,0177,0004,0003,0184,
01074, CRUZEIRO DO SUL ,0004,2143,0391,0078,0017,0053,0153,0293,0206,0003,0006,0215,
01074, CRUZEIRO DO SUL ,0004,1406,0392,0082,0045,0057,0153,0297,0210,0001,0004,0215,
01074, CRUZEIRO DO SUL ,0004,1481,0393,0093,0021,0043,0146,0292,0189,0001,0009,0199,
01074, CRUZEIRO DO SUL ,0004,1198,0394,0075,0027,0035,0155,0268,0190,0003,0000,0193,
01074, CRUZEIRO DO SUL ,0004,1368,0395,0048,0033,0035,0112,0200,0147,0003,0002,0152,
01074, CRUZEIRO DO SUL ,0004,1155,0396,0071,0037,0042,0168,0289,0210,0001,0007,0218,
01074, CRUZEIRO DO SUL ,0004,2232,0397,0080,0033,0054,0155,0300,0209,0004,0007,0220,
01074, CRUZEIRO DO SUL ,0004,1392,0398,0049,0036,0046,0167,0268,0213,0002,0004,0219,
01074, CRUZEIRO DO SUL ,0004,1384,0399,0064,0036,0032,0162,0263,0194,0001,0004,0199,
01074, CRUZEIRO DO SUL ,0004,1554,0400,0073,0041,0034,0177,0287,0211,0001,0002,0214,
01074, CRUZEIRO DO SUL ,0004,1376,0401,0057,0015,0027,0114,0202,0141,0003,0001,0145,
01074, CRUZEIRO DO SUL ,0004,2135,0402,0075,0026,0054,0154,0294,0208,0002,0009,0219,
01074, CRUZEIRO DO SUL ,0004,1643,0403,0127,0014,0046,0112,0290,0158,0000,0005,0163,
01074, CRUZEIRO DO SUL ,0004,2348,0404,0058,0023,0055,0185,0305,0240,0002,0005,0247,
01074, CRUZEIRO DO SUL ,0004,2160,0405,0081,0031,0043,0159,0284,0202,0001,0000,0203,
01074, CRUZEIRO DO SUL ,0004,1791,0406,0095,0022,0023,0174,0297,0197,0003,0002,0202,
01074, CRUZEIRO DO SUL ,0004,2127,0407,0080,0032,0047,0155,0287,0202,0001,0004,0207,
01074, CRUZEIRO DO SUL ,0004,1295,0408,0102,0028,0042,0150,0294,0192,0000,0000,0192,
01074, CRUZEIRO DO SUL ,0004,1155,0409,0097,0046,0043,0151,0296,0194,0002,0003,0199,
01074, CRUZEIRO DO SUL ,0004,1554,0410,0073,0021,0040,0174,0290,0214,0002,0001,0217,
01074, CRUZEIRO DO SUL ,0004,1481,0411,0076,0022,0046,0162,0293,0208,0005,0004,0217,
01074, CRUZEIRO DO SUL ,0004,1520,0412,0069,0032,0036,0124,0230,0160,0000,0001,0161,
01074, CRUZEIRO DO SUL ,0004,1171,0413,0076,0037,0034,0141,0254,0175,0001,0002,0178,
01074, CRUZEIRO DO SUL ,0004,2240,0415,0112,0022,0046,0107,0268,0153,0001,0002,0156,
01074, CRUZEIRO DO SUL ,0004,1392,0416,0067,0025,0039,0161,0269,0200,0002,0000,0202,
01074, CRUZEIRO DO SUL ,0004,1570,0417,0066,0033,0041,0128,0239,0169,0000,0004,0173,
01074, CRUZEIRO DO SUL ,0004,1384,0418,0083,0030,0042,0127,0257,0169,0003,0002,0174,
01074, CRUZEIRO DO SUL ,0004,1295,0419,0098,0030,0035,0158,0295,0193,0003,0001,0197,
01074, CRUZEIRO DO SUL ,0004,1198,0420,0079,0025,0025,0152,0259,0177,0002,0001,0180,
01074, CRUZEIRO DO SUL ,0004,1228,0421,0103,0024,0028,0110,0245,0138,0003,0001,0142,
01074, CRUZEIRO DO SUL ,0004,1333,0422,0150,0032,0071,0092,0317,0163,0000,0004,0167,
01074, CRUZEIRO DO SUL ,0004,2348,0423,0088,0021,0056,0149,0300,0205,0003,0004,0212,
01074, CRUZEIRO DO SUL ,0004,2364,0446,0021,0014,0012,0084,0119,0096,0000,0002,0098,
01074, CRUZEIRO DO SUL ,0004,2372,0452,0034,0008,0034,0050,0120,0084,0000,0002,0086,
01082, RODRIGUES ALVES ,0004,1015,0082,0100,0023,0056,0135,0294,0191,0000,0003,0194,
01082, RODRIGUES ALVES ,0004,1023,0083,0096,0047,0035,0109,0242,0144,0001,0001,0146,
01082, RODRIGUES ALVES ,0004,1031,0084,0105,0047,0038,0149,0298,0187,0002,0004,0193,
01082, RODRIGUES ALVES ,0004,1015,0148,0133,0029,0026,0141,0303,0167,0001,0002,0170,
01082, RODRIGUES ALVES ,0004,1023,0149,0084,0029,0031,0104,0223,0135,0002,0002,0139,
01082, RODRIGUES ALVES ,0004,1031,0150,0095,0040,0045,0154,0296,0199,0000,0002,0201,
01082, RODRIGUES ALVES ,0004,1015,0169,0102,0023,0038,0146,0290,0184,0002,0002,0188,
01082, RODRIGUES ALVES ,0004,1023,0170,0086,0019,0024,0123,0235,0147,0001,0001,0149,
01082, RODRIGUES ALVES ,0004,1031,0171,0114,0021,0036,0135,0293,0171,0002,0006,0179,
01082, RODRIGUES ALVES ,0004,1040,0174,0116,0014,0026,0091,0235,0117,0000,0002,0119,
01082, RODRIGUES ALVES ,0004,1023,0176,0063,0027,0041,0113,0220,0154,0001,0002,0157,
01082, RODRIGUES ALVES ,0004,1015,0193,0092,0019,0034,0148,0280,0182,0003,0003,0188,
01082, RODRIGUES ALVES ,0004,1058,0197,0073,0019,0047,0091,0216,0138,0004,0001,0143,
01082, RODRIGUES ALVES ,0004,1074,0209,0080,0025,0042,0147,0278,0189,0003,0006,0198,
01082, RODRIGUES ALVES ,0004,1066,0212,0079,0019,0031,0107,0218,0138,0000,0001,0139,
01082, RODRIGUES ALVES ,0004,1058,0215,0069,0034,0045,0116,0232,0161,0001,0001,0163,
01082, RODRIGUES ALVES ,0004,1074,0225,0084,0014,0035,0151,0273,0186,0002,0001,0189,
01082, RODRIGUES ALVES ,0004,1066,0226,0071,0018,0031,0117,0221,0148,0002,0000,0150,
01082, RODRIGUES ALVES ,0004,1104,0231,0072,0030,0063,0168,0309,0231,0005,0001,0237,
01082, RODRIGUES ALVES ,0004,1090,0232,0059,0044,0029,0135,0225,0164,0000,0002,0166,
01082, RODRIGUES ALVES ,0004,1082,0233,0129,0012,0051,0131,0315,0182,0001,0003,0186,
01082, RODRIGUES ALVES ,0004,1112,0234,0114,0025,0014,0138,0267,0152,0000,0001,0153,
01082, RODRIGUES ALVES ,0004,1112,0241,0101,0027,0014,0144,0262,0158,0002,0001,0161,
01082, RODRIGUES ALVES ,0004,1104,0250,0090,0033,0056,0176,0325,0232,0002,0001,0235,
01082, RODRIGUES ALVES ,0004,1120,0272,0081,0019,0027,0057,0168,0084,0000,0003,0087,
01082, RODRIGUES ALVES ,0004,1139,0274,0095,0031,0011,0168,0275,0179,0000,0001,0180,
01082, RODRIGUES ALVES ,0004,1147,0281,0120,0021,0034,0072,0229,0106,0001,0002,0109,
01082, RODRIGUES ALVES ,0004,1163,0290,0065,0021,0018,0126,0212,0144,0002,0001,0147,
01082, RODRIGUES ALVES ,0004,1155,0292,0085,0019,0019,0178,0282,0197,0000,0000,0197,
01082, RODRIGUES ALVES ,0004,1090,0298,0070,0023,0022,0127,0220,0149,0001,0000,0150,
01082, RODRIGUES ALVES ,0004,1171,0299,0126,0014,0012,0117,0257,0129,0001,0001,0131,
01082, RODRIGUES ALVES ,0004,1180,0302,0049,0017,0013,0093,0156,0106,0001,0000,0107,
01082, RODRIGUES ALVES ,0004,1198,0304,0086,0015,0014,0098,0199,0112,0000,0001,0113,
01082, RODRIGUES ALVES ,0004,1201,0309,0095,0039,0033,0183,0313,0216,0001,0001,0218,
01082, RODRIGUES ALVES ,0004,1210,0317,0092,0019,0020,0194,0306,0214,0000,0000,0214,
01082, RODRIGUES ALVES ,0004,1074,0349,0112,0021,0030,0119,0261,0149,0000,0000,0149,
01082, RODRIGUES ALVES ,0004,1015,0351,0112,0022,0026,0121,0260,0147,0000,0001,0148,
01082, RODRIGUES ALVES ,0004,1104,0357,0100,0019,0048,0145,0296,0193,0003,0000,0196,
01082, RODRIGUES ALVES ,0004,1066,0377,0083,0015,0020,0088,0191,0108,0000,0000,0108,
01082, RODRIGUES ALVES ,0004,1090,0380,0063,0025,0028,0114,0205,0142,0000,0000,0142,
01082, RODRIGUES ALVES ,0004,1066,0387,0065,0013,0023,0111,0202,0134,0001,0002,0137,
01082, RODRIGUES ALVES ,0004,1015,0388,0115,0023,0028,0110,0254,0138,0001,0000,0139,
01082, RODRIGUES ALVES ,0004,1139,0427,0037,0016,0009,0049,0095,0058,0000,0000,0058,
01082, RODRIGUES ALVES ,0004,1058,0428,0042,0009,0029,0062,0134,0091,0000,0001,0092,
01082, RODRIGUES ALVES ,0004,1023,0431,0065,0012,0030,0093,0191,0123,0000,0003,0126,
01082, RODRIGUES ALVES ,0004,1228,0438,0097,0022,0029,0132,0260,0161,0001,0001,0163,
01082, RODRIGUES ALVES ,0004,1236,0440,0084,0015,0025,0162,0273,0187,0000,0002,0189,
01082, RODRIGUES ALVES ,0004,1228,0455,0057,0015,0019,0123,0200,0142,0001,0000,0143,
01090, MÂNCIO LIMA ,0004,1015,0089,0096,0035,0045,0127,0269,0172,0001,0000,0173,
01090, MÂNCIO LIMA ,0004,1023,0090,0061,0022,0035,0087,0183,0122,0000,0000,0122,
01090, MÂNCIO LIMA ,0004,1031,0091,0101,0029,0036,0119,0261,0155,0002,0003,0160,
01090, MÂNCIO LIMA ,0004,1040,0092,0086,0043,0044,0148,0280,0192,0001,0001,0194,
01090, MÂNCIO LIMA ,0004,1058,0093,0096,0038,0049,0165,0311,0214,0000,0001,0215,
01090, MÂNCIO LIMA ,0004,1066,0094,0046,0016,0037,0082,0170,0119,0001,0004,0124,
01090, MÂNCIO LIMA ,0004,1058,0095,0078,0035,0052,0163,0301,0215,0001,0007,0223,
01090, MÂNCIO LIMA ,0004,1023,0096,0095,0026,0042,0169,0307,0211,0000,0001,0212,
01090, MÂNCIO LIMA ,0004,1139,0097,0074,0037,0036,0151,0264,0187,0002,0001,0190,
01090, MÂNCIO LIMA ,0004,1112,0099,0068,0013,0031,0075,0176,0106,0000,0002,0108,
01090, MÂNCIO LIMA ,0004,1112,0100,0051,0019,0030,0080,0167,0110,0003,0003,0116,
01090, MÂNCIO LIMA ,0004,1120,0101,0095,0009,0065,0154,0320,0219,0005,0001,0225,
01090, MÂNCIO LIMA ,0004,1120,0102,0099,0024,0081,0112,0296,0193,0003,0001,0197,
01090, MÂNCIO LIMA ,0004,1139,0103,0100,0035,0039,0133,0272,0172,0000,0000,0172,
01090, MÂNCIO LIMA ,0004,1147,0104,0058,0035,0077,0156,0298,0233,0003,0004,0240,
01090, MÂNCIO LIMA ,0004,1031,0116,0078,0021,0043,0136,0258,0179,0001,0000,0180,
01090, MÂNCIO LIMA ,0004,1031,0122,0091,0013,0048,0124,0266,0172,0001,0002,0175,
01090, MÂNCIO LIMA ,0004,1031,0127,0078,0017,0048,0125,0256,0173,0001,0004,0178,
01090, MÂNCIO LIMA ,0004,1163,0151,0106,0020,0075,0069,0253,0144,0001,0002,0147,
01090, MÂNCIO LIMA ,0004,1058,0153,0107,0041,0051,0147,0308,0198,0001,0002,0201,
01090, MÂNCIO LIMA ,0004,1210,0172,0137,0036,0034,0106,0277,0140,0000,0000,0140,
01090, MÂNCIO LIMA ,0004,1180,0177,0095,0012,0017,0059,0172,0076,0000,0001,0077,
01090, MÂNCIO LIMA ,0004,1120,0180,0087,0041,0073,0127,0292,0200,0003,0002,0205,
01090, MÂNCIO LIMA ,0004,1163,0181,0099,0029,0094,0043,0242,0137,0001,0005,0143,
01090, MÂNCIO LIMA ,0004,1147,0190,0059,0056,0071,0165,0300,0236,0003,0002,0241,
01090, MÂNCIO LIMA ,0004,1120,0216,0080,0024,0058,0151,0295,0209,0002,0004,0215,
01090, MÂNCIO LIMA ,0004,1090,0217,0108,0026,0025,0086,0219,0111,0000,0000,0111,
01090, MÂNCIO LIMA ,0004,1074,0218,0191,0018,0032,0102,0326,0134,0001,0000,0135,
01090, MÂNCIO LIMA ,0004,1015,0248,0088,0036,0028,0132,0251,0160,0002,0001,0163,
01090, MÂNCIO LIMA ,0004,1066,0264,0046,0015,0032,0087,0168,0119,0000,0003,0122,
01090, MÂNCIO LIMA ,0004,1147,0265,0077,0044,0061,0163,0303,0224,0001,0001,0226,
01090, MÂNCIO LIMA ,0004,1120,0267,0091,0026,0056,0142,0294,0198,0003,0002,0203,
01090, MÂNCIO LIMA ,0004,1201,0273,0080,0026,0068,0089,0240,0157,0000,0003,0160,
01090, MÂNCIO LIMA ,0004,1201,0276,0061,0018,0067,0098,0233,0165,0001,0006,0172,
01090, MÂNCIO LIMA ,0004,1198,0277,0031,0056,0129,0141,0302,0270,0001,0000,0271,
01090, MÂNCIO LIMA ,0004,1210,0283,0170,0012,0017,0080,0269,0097,0000,0002,0099,
01090, MÂNCIO LIMA ,0004,1228,0303,0078,0026,0084,0062,0225,0146,0001,0000,0147,
01090, MÂNCIO LIMA ,0004,1236,0307,0058,0020,0087,0110,0259,0197,0004,0000,0201,
01090, MÂNCIO LIMA ,0004,1244,0310,0073,0054,0054,0160,0293,0214,0003,0003,0220,
01090, MÂNCIO LIMA ,0004,1147,0335,0080,0037,0049,0149,0284,0198,0001,0005,0204,
01090, MÂNCIO LIMA ,0004,1120,0346,0100,0008,0058,0106,0269,0164,0002,0003,0169,
01090, MÂNCIO LIMA ,0004,1058,0364,0103,0021,0024,0145,0281,0169,0004,0005,0178,
01090, MÂNCIO LIMA ,0004,1139,0366,0095,0023,0029,0113,0238,0142,0001,0000,0143,
01090, MÂNCIO LIMA ,0004,1244,0367,0085,0035,0049,0141,0280,0190,0005,0000,0195,
01090, MÂNCIO LIMA ,0004,1198,0369,0041,0023,0085,0071,0197,0156,0000,0000,0156,
01090, MÂNCIO LIMA ,0004,1147,0414,0083,0029,0066,0126,0282,0192,0002,0005,0199,
01090, MÂNCIO LIMA ,0004,1120,0425,0086,0040,0048,0136,0275,0184,0003,0002,0189,
01090, MÂNCIO LIMA ,0004,1201,0426,0070,0017,0045,0097,0215,0142,0002,0001,0145,
01090, MÂNCIO LIMA ,0004,1058,0432,0105,0029,0029,0148,0285,0177,0000,0003,0180,
01090, MÂNCIO LIMA ,0004,1139,0433,0085,0032,0027,0122,0241,0149,0004,0003,0156,
01090, MÂNCIO LIMA ,0004,1120,0436,0101,0039,0045,0119,0272,0164,0003,0004,0171,
01090, MÂNCIO LIMA ,0004,1147,0437,0082,0037,0065,0131,0281,0196,0001,0002,0199,
01090, MÂNCIO LIMA ,0004,1244,0439,0054,0031,0038,0102,0195,0140,0001,0000,0141,
01104, JORDÃO ,0005,1112,0027,0116,0018,0112,0098,0333,0210,0004,0003,0217,
01104, JORDÃO ,0005,1023,0028,0117,0007,0078,0081,0280,0159,0001,0003,0163,
01104, JORDÃO ,0005,1112,0032,0123,0007,0104,0095,0328,0199,0000,0006,0205,
01104, JORDÃO ,0005,1112,0037,0092,0023,0118,0095,0312,0213,0000,0007,0220,
01104, JORDÃO ,0005,1112,0045,0098,0033,0112,0087,0305,0199,0005,0003,0207,
01104, JORDÃO ,0005,1112,0046,0093,0013,0108,0096,0302,0204,0001,0004,0209,
01104, JORDÃO ,0005,1040,0052,0074,0012,0079,0089,0249,0168,0002,0005,0175,
01104, JORDÃO ,0005,1066,0056,0090,0003,0034,0038,0165,0072,0000,0003,0075,
01104, JORDÃO ,0005,1058,0057,0096,0008,0033,0076,0208,0109,0001,0002,0112,
01104, JORDÃO ,0005,1066,0062,0210,0023,0047,0051,0310,0098,0000,0002,0100,
01104, JORDÃO ,0005,1074,0065,0092,0040,0122,0005,0221,0127,0001,0001,0129,
01104, JORDÃO ,0005,1074,0066,0079,0027,0215,0015,0320,0230,0000,0011,0241,
01104, JORDÃO ,0005,1104,0067,0068,0028,0108,0059,0239,0167,0002,0002,0171,
01104, JORDÃO ,0005,1023,0075,0066,0020,0097,0076,0242,0173,0000,0003,0176,
01104, JORDÃO ,0005,1058,0100,0106,0005,0023,0079,0209,0102,0001,0000,0103,
01104, JORDÃO ,0005,1031,0112,0100,0013,0104,0083,0291,0187,0002,0002,0191,
01104, JORDÃO ,0005,1031,0118,0086,0013,0076,0091,0256,0167,0002,0001,0170,
01104, JORDÃO ,0005,1040,0122,0085,0030,0100,0044,0233,0144,0001,0003,0148,
01104, JORDÃO ,0005,1031,0123,0106,0007,0103,0068,0279,0171,0000,0002,0173,
01104, JORDÃO ,0005,1031,0126,0093,0011,0094,0039,0226,0133,0000,0000,0133,
01104, JORDÃO ,0005,1031,0131,0098,0009,0113,0068,0282,0181,0001,0002,0184,
01112, EPITACIOLÂNDIA ,0006,1295,0009,0079,0016,0054,0155,0290,0209,0001,0001,0211,
01112, EPITACIOLÂNDIA ,0006,1295,0010,0069,0007,0054,0158,0286,0212,0002,0003,0217,
01112, EPITACIOLÂNDIA ,0006,1210,0022,0056,0022,0052,0164,0276,0216,0001,0003,0220,
01112, EPITACIOLÂNDIA ,0006,1392,0026,0061,0008,0040,0161,0269,0201,0004,0003,0208,
01112, EPITACIOLÂNDIA ,0006,1058,0034,0067,0013,0069,0149,0289,0218,0002,0002,0222,
01112, EPITACIOLÂNDIA ,0006,1058,0040,0075,0004,0050,0156,0291,0206,0002,0008,0216,
01112, EPITACIOLÂNDIA ,0006,1309,0042,0060,0019,0057,0172,0291,0229,0001,0001,0231,
01112, EPITACIOLÂNDIA ,0006,1015,0046,0073,0015,0058,0164,0297,0222,0000,0002,0224,
01112, EPITACIOLÂNDIA ,0006,1309,0047,0075,0019,0060,0152,0292,0212,0003,0002,0217,
01112, EPITACIOLÂNDIA ,0006,1309,0048,0076,0008,0053,0160,0292,0213,0001,0002,0216,
01112, EPITACIOLÂNDIA ,0006,1031,0049,0054,0009,0051,0179,0286,0230,0002,0000,0232,
01112, EPITACIOLÂNDIA ,0006,1031,0050,0072,0011,0041,0170,0286,0211,0001,0002,0214,
01112, EPITACIOLÂNDIA ,0006,1058,0051,0079,0010,0059,0138,0284,0197,0004,0004,0205,
01112, EPITACIOLÂNDIA ,0006,1015,0059,0072,0014,0063,0154,0297,0217,0002,0006,0225,
01112, EPITACIOLÂNDIA ,0006,1031,0060,0053,0008,0052,0173,0285,0225,0001,0006,0232,
01112, EPITACIOLÂNDIA ,0006,1031,0061,0068,0009,0046,0159,0280,0205,0004,0003,0212,
01112, EPITACIOLÂNDIA ,0006,1210,0064,0051,0004,0050,0165,0270,0215,0002,0002,0219,
01112, EPITACIOLÂNDIA ,0006,1406,0065,0057,0013,0064,0167,0292,0231,0002,0002,0235,
01112, EPITACIOLÂNDIA ,0006,1058,0068,0074,0003,0070,0132,0282,0202,0003,0003,0208,
01112, EPITACIOLÂNDIA ,0006,1317,0069,0081,0014,0041,0131,0254,0172,0000,0001,0173,
01112, EPITACIOLÂNDIA ,0006,1317,0070,0051,0008,0049,0103,0205,0152,0001,0001,0154,
01112, EPITACIOLÂNDIA ,0006,1252,0071,0030,0005,0044,0173,0252,0217,0001,0004,0222,
01112, EPITACIOLÂNDIA ,0006,1317,0072,0045,0001,0031,0128,0205,0159,0000,0001,0160,
01112, EPITACIOLÂNDIA ,0006,1210,0077,0072,0020,0034,0153,0266,0187,0000,0007,0194,
01112, EPITACIOLÂNDIA ,0006,1287,0082,0073,0007,0049,0121,0246,0170,0003,0000,0173,
01112, EPITACIOLÂNDIA ,0006,1015,0086,0067,0016,0069,0161,0299,0230,0000,0002,0232,
01112, EPITACIOLÂNDIA ,0006,1317,0096,0038,0010,0042,0122,0203,0164,0001,0000,0165,
01112, EPITACIOLÂNDIA ,0006,1325,0097,0052,0008,0066,0088,0212,0154,0001,0005,0160,
01112, EPITACIOLÂNDIA ,0006,1376,0098,0063,0003,0097,0079,0241,0176,0001,0001,0178,
01112, EPITACIOLÂNDIA ,0006,1414,0101,0050,0004,0055,0101,0209,0156,0000,0003,0159,
01112, EPITACIOLÂNDIA ,0006,1333,0103,0089,0010,0091,0115,0298,0206,0002,0001,0209,
01112, EPITACIOLÂNDIA ,0006,1031,0105,0069,0007,0045,0168,0284,0213,0000,0002,0215,
01112, EPITACIOLÂNDIA ,0006,1309,0106,0068,0009,0047,0163,0282,0210,0002,0002,0214,
01112, EPITACIOLÂNDIA ,0006,1210,0107,0068,0017,0062,0139,0275,0201,0002,0004,0207,
01112, EPITACIOLÂNDIA ,0006,1058,0116,0077,0004,0050,0160,0287,0210,0000,0000,0210,
01112, EPITACIOLÂNDIA ,0006,1309,0123,0068,0004,0050,0176,0296,0226,0002,0000,0228,
01112, EPITACIOLÂNDIA ,0006,1368,0124,0113,0013,0051,0124,0291,0175,0001,0002,0178,
01112, EPITACIOLÂNDIA ,0006,1287,0125,0079,0014,0052,0119,0254,0171,0001,0003,0175,
01112, EPITACIOLÂNDIA ,0006,1309,0134,0093,0005,0053,0146,0296,0199,0003,0001,0203,
01112, EPITACIOLÂNDIA ,0006,1368,0135,0084,0010,0062,0139,0288,0201,0002,0001,0204,
01112, EPITACIOLÂNDIA ,0006,1252,0141,0016,0003,0020,0077,0115,0097,0001,0001,0099,
01112, EPITACIOLÂNDIA ,0006,1287,0142,0067,0001,0041,0130,0241,0171,0003,0000,0174,
01112, EPITACIOLÂNDIA ,0006,1015,0144,0102,0009,0046,0148,0303,0194,0003,0004,0201,
01112, EPITACIOLÂNDIA ,0006,1392,0145,0029,0006,0016,0069,0115,0085,0001,0000,0086,
01112, EPITACIOLÂNDIA ,0006,1406,0147,0077,0003,0049,0162,0294,0211,0004,0002,0217,
01112, EPITACIOLÂNDIA ,0006,1210,0148,0062,0005,0047,0163,0277,0210,0003,0002,0215,
01112, EPITACIOLÂNDIA ,0006,1368,0151,0084,0001,0062,0143,0291,0205,0002,0000,0207,
01120, ACRELÂNDIA ,0008,1015,0008,0048,0037,0041,0111,0201,0152,0001,0000,0153,
01120, ACRELÂNDIA ,0008,1015,0009,0064,0029,0028,0105,0199,0133,0002,0000,0135,
01120, ACRELÂNDIA ,0008,1023,0064,0055,0048,0041,0123,0225,0164,0001,0005,0170,
01120, ACRELÂNDIA ,0008,1023,0072,0062,0054,0042,0116,0223,0158,0000,0003,0161,
01120, ACRELÂNDIA ,0008,1023,0077,0063,0046,0031,0122,0225,0153,0004,0005,0162,
01120, ACRELÂNDIA ,0008,1015,0083,0044,0043,0028,0125,0197,0153,0000,0000,0153,
01120, ACRELÂNDIA ,0008,1023,0084,0061,0046,0032,0126,0223,0158,0002,0002,0162,
01120, ACRELÂNDIA ,0008,1031,0085,0058,0052,0055,0194,0309,0249,0001,0001,0251,
01120, ACRELÂNDIA ,0008,1058,0093,0045,0046,0036,0131,0215,0167,0002,0001,0170,
01120, ACRELÂNDIA ,0008,1066,0094,0041,0033,0037,0114,0195,0151,0001,0002,0154,
01120, ACRELÂNDIA ,0008,1040,0095,0039,0029,0035,0098,0176,0133,0002,0002,0137,
01120, ACRELÂNDIA ,0008,1066,0099,0048,0029,0028,0117,0195,0145,0001,0001,0147,
01120, ACRELÂNDIA ,0008,1074,0101,0071,0043,0041,0163,0278,0204,0000,0003,0207,
01120, ACRELÂNDIA ,0008,1040,0102,0037,0026,0045,0096,0180,0141,0001,0001,0143,
01120, ACRELÂNDIA ,0008,1074,0115,0069,0036,0044,0158,0276,0202,0001,0004,0207,
01120, ACRELÂNDIA ,0008,1210,0117,0062,0057,0032,0124,0223,0156,0002,0003,0161,
01120, ACRELÂNDIA ,0008,1074,0123,0062,0030,0038,0172,0280,0210,0003,0005,0218,
01120, ACRELÂNDIA ,0008,1066,0124,0051,0020,0040,0098,0192,0138,0000,0003,0141,
01120, ACRELÂNDIA ,0008,1058,0125,0051,0028,0032,0136,0220,0168,0000,0001,0169,
01120, ACRELÂNDIA ,0008,1040,0132,0022,0024,0031,0117,0172,0148,0000,0002,0150,
01120, ACRELÂNDIA ,0008,1074,0142,0077,0051,0033,0161,0278,0194,0002,0005,0201,
01120, ACRELÂNDIA ,0008,1015,0143,0060,0029,0027,0113,0203,0140,0001,0002,0143,
01120, ACRELÂNDIA ,0008,1066,0146,0060,0020,0025,0107,0193,0132,0000,0001,0133,
01120, ACRELÂNDIA ,0008,1040,0159,0093,0042,0040,0178,0313,0218,0002,0000,0220,
01120, ACRELÂNDIA ,0008,1074,0162,0080,0037,0038,0164,0285,0202,0002,0001,0205,
01120, ACRELÂNDIA ,0008,1112,0164,0046,0015,0017,0091,0156,0108,0000,0002,0110,
01120, ACRELÂNDIA ,0008,1120,0169,0066,0032,0034,0130,0232,0164,0002,0000,0166,
01120, ACRELÂNDIA ,0008,1031,0178,0070,0054,0056,0180,0309,0236,0002,0001,0239,
01120, ACRELÂNDIA ,0008,1120,0181,0060,0044,0041,0121,0230,0162,0000,0008,0170,
01120, ACRELÂNDIA ,0008,1139,0182,0069,0034,0046,0143,0261,0189,0000,0003,0192,
01120, ACRELÂNDIA ,0008,1120,0185,0071,0027,0022,0136,0233,0158,0002,0002,0162,
01120, ACRELÂNDIA ,0008,1120,0186,0058,0043,0031,0132,0226,0163,0003,0002,0168,
01120, ACRELÂNDIA ,0008,1198,0198,0033,0029,0028,0052,0114,0080,0000,0001,0081,
01120, ACRELÂNDIA ,0008,1180,0199,0083,0033,0049,0105,0241,0154,0001,0003,0158,
01120, ACRELÂNDIA ,0008,1040,0205,0055,0041,0027,0118,0202,0145,0002,0000,0147,
01120, ACRELÂNDIA ,0008,1210,0209,0077,0025,0038,0105,0223,0143,0000,0003,0146,
01120, ACRELÂNDIA ,0008,1139,0215,0076,0031,0033,0153,0265,0186,0001,0002,0189,
01120, ACRELÂNDIA ,0008,1023,0224,0093,0023,0027,0103,0229,0130,0003,0003,0136,
01120, ACRELÂNDIA ,0008,1120,0232,0066,0026,0031,0136,0235,0167,0001,0001,0169,
01120, ACRELÂNDIA ,0008,1015,0233,0073,0038,0022,0098,0197,0120,0001,0003,0124,
01120, ACRELÂNDIA ,0008,1058,0235,0091,0026,0032,0129,0252,0161,0000,0000,0161,
01120, ACRELÂNDIA ,0008,1120,0256,0092,0027,0026,0116,0241,0142,0002,0005,0149,
01139, FEIJÓ ,0007,1058,0001,0114,0006,0077,0077,0271,0154,0000,0003,0157,
01139, FEIJÓ ,0007,1031,0002,0125,0025,0076,0084,0290,0160,0002,0003,0165,
01139, FEIJÓ ,0007,1031,0003,0094,0008,0084,0087,0273,0171,0003,0005,0179,
01139, FEIJÓ ,0007,1031,0004,0093,0008,0094,0092,0285,0186,0002,0004,0192,
01139, FEIJÓ ,0007,1031,0005,0096,0006,0077,0105,0283,0182,0004,0001,0187,
01139, FEIJÓ ,0007,1040,0006,0097,0003,0061,0063,0226,0124,0001,0004,0129,
01139, FEIJÓ ,0007,1040,0007,0081,0004,0077,0069,0229,0146,0000,0002,0148,
01139, FEIJÓ ,0007,1040,0008,0098,0017,0069,0074,0244,0143,0002,0001,0146,
01139, FEIJÓ ,0007,1040,0009,0096,0016,0054,0063,0218,0117,0002,0003,0122,
01139, FEIJÓ ,0007,1040,0010,0062,0011,0089,0076,0230,0165,0001,0002,0168,
01139, FEIJÓ ,0007,1058,0011,0107,0012,0085,0076,0271,0161,0001,0002,0164,
01139, FEIJÓ ,0007,1058,0012,0118,0010,0081,0070,0275,0151,0002,0004,0157,
01139, FEIJÓ ,0007,1058,0013,0107,0018,0085,0085,0283,0170,0003,0003,0176,
01139, FEIJÓ ,0007,1058,0014,0123,0011,0068,0078,0271,0146,0001,0001,0148,
01139, FEIJÓ ,0007,1058,0015,0122,0014,0075,0071,0275,0146,0002,0005,0153,
01139, FEIJÓ ,0007,1325,0016,0088,0013,0065,0070,0230,0135,0005,0002,0142,
01139, FEIJÓ ,0007,1074,0017,0105,0009,0083,0089,0282,0172,0000,0005,0177,
01139, FEIJÓ ,0007,1074,0018,0125,0000,0076,0077,0281,0153,0002,0001,0156,
01139, FEIJÓ ,0007,1058,0019,0090,0039,0100,0074,0271,0174,0002,0005,0181,
01139, FEIJÓ ,0007,1031,0020,0098,0011,0080,0096,0281,0176,0004,0003,0183,
01139, FEIJÓ ,0007,1031,0021,0092,0005,0057,0116,0268,0173,0001,0002,0176,
01139, FEIJÓ ,0007,1031,0022,0113,0017,0076,0090,0279,0166,0000,0000,0166,
01139, FEIJÓ ,0007,1031,0023,0091,0012,0085,0094,0281,0179,0007,0004,0190,
01139, FEIJÓ ,0007,1074,0024,0130,0011,0076,0081,0296,0157,0003,0006,0166,
01139, FEIJÓ ,0007,1112,0025,0096,0028,0074,0071,0247,0145,0002,0004,0151,
01139, FEIJÓ ,0007,1112,0026,0098,0013,0063,0084,0251,0147,0003,0003,0153,
01139, FEIJÓ ,0007,1325,0027,0076,0005,0065,0085,0231,0150,0001,0004,0155,
01139, FEIJÓ ,0007,1325,0028,0083,0006,0069,0068,0227,0137,0003,0004,0144,
01139, FEIJÓ ,0007,1325,0029,0093,0006,0075,0061,0233,0136,0002,0002,0140,
01139, FEIJÓ ,0007,1147,0030,0095,0016,0088,0072,0261,0160,0001,0005,0166,
01139, FEIJÓ ,0007,1147,0031,0095,0010,0092,0066,0257,0158,0002,0002,0162,
01139, FEIJÓ ,0007,1058,0032,0126,0009,0067,0076,0276,0143,0002,0005,0150,
01139, FEIJÓ ,0007,1058,0033,0099,0015,0079,0073,0256,0152,0002,0003,0157,
01139, FEIJÓ ,0007,1163,0034,0128,0009,0099,0094,0324,0193,0002,0001,0196,
01139, FEIJÓ ,0007,1074,0035,0100,0015,0080,0081,0272,0161,0002,0009,0172,
01139, FEIJÓ ,0007,1040,0036,0065,0005,0061,0081,0217,0142,0002,0008,0152,
01139, FEIJÓ ,0007,1163,0037,0130,0010,0087,0087,0314,0174,0004,0006,0184,
01139, FEIJÓ ,0007,1074,0038,0100,0007,0068,0092,0269,0160,0001,0008,0169,
01139, FEIJÓ ,0007,1163,0039,0109,0003,0094,0101,0315,0195,0004,0007,0206,
01139, FEIJÓ ,0007,1180,0040,0107,0007,0112,0074,0299,0186,0001,0005,0192,
01139, FEIJÓ ,0007,1171,0041,0121,0007,0089,0110,0327,0199,0003,0004,0206,
01139, FEIJÓ ,0007,1031,0042,0084,0008,0081,0100,0271,0181,0003,0003,0187,
01139, FEIJÓ ,0007,1112,0043,0077,0003,0067,0085,0229,0152,0000,0000,0152,
01139, FEIJÓ ,0007,1171,0044,0116,0018,0088,0112,0323,0200,0003,0004,0207,
01139, FEIJÓ ,0007,1198,0045,0108,0016,0136,0057,0309,0193,0000,0008,0201,
01139, FEIJÓ ,0007,1201,0046,0111,0005,0048,0040,0203,0088,0000,0004,0092,
01139, FEIJÓ ,0007,1210,0047,0127,0009,0068,0028,0224,0096,0000,0001,0097,
01139, FEIJÓ ,0007,1180,0048,0132,0009,0100,0081,0318,0181,0001,0004,0186,
01139, FEIJÓ ,0007,1171,0049,0127,0021,0071,0114,0320,0185,0003,0005,0193,
01139, FEIJÓ ,0007,1325,0050,0080,0004,0062,0075,0219,0137,0000,0002,0139,
01139, FEIJÓ ,0007,1163,0051,0113,0014,0089,0111,0315,0200,0002,0000,0202,
01139, FEIJÓ ,0007,1228,0052,0207,0003,0052,0022,0292,0074,0001,0010,0085,
01139, FEIJÓ ,0007,1236,0053,0130,0004,0112,0056,0302,0168,0003,0001,0172,
01139, FEIJÓ ,0007,1171,0054,0098,0012,0091,0129,0320,0220,0000,0002,0222,
01139, FEIJÓ ,0007,1201,0056,0111,0009,0047,0042,0203,0089,0002,0001,0092,
01139, FEIJÓ ,0007,1180,0057,0113,0012,0109,0081,0310,0190,0001,0006,0197,
01139, FEIJÓ ,0007,1031,0058,0096,0017,0060,0102,0263,0162,0002,0003,0167,
01139, FEIJÓ ,0007,1074,0059,0109,0006,0060,0099,0270,0159,0002,0000,0161,
01139, FEIJÓ ,0007,1112,0060,0079,0007,0056,0085,0223,0141,0000,0003,0144,
01139, FEIJÓ ,0007,1244,0062,0127,0004,0105,0095,0331,0200,0002,0002,0204,
01139, FEIJÓ ,0007,1198,0063,0104,0007,0144,0068,0318,0212,0000,0002,0214,
01139, FEIJÓ ,0007,1163,0064,0125,0008,0089,0102,0319,0191,0000,0003,0194,
01139, FEIJÓ ,0007,1210,0065,0144,0052,0050,0029,0226,0079,0001,0002,0082,
01139, FEIJÓ ,0007,1228,0066,0108,0001,0021,0013,0145,0034,0000,0003,0037,
01139, FEIJÓ ,0007,1341,0067,0091,0004,0055,0009,0184,0064,0002,0027,0093,
01139, FEIJÓ ,0007,1279,0068,0104,0001,0062,0027,0198,0089,0000,0005,0094,
01139, FEIJÓ ,0007,1341,0069,0124,0004,0045,0001,0196,0046,0002,0024,0072,
01139, FEIJÓ ,0007,1260,0070,0074,0007,0219,0011,0308,0230,0001,0003,0234,
01139, FEIJÓ ,0007,1252,0071,0040,0012,0260,0005,0308,0265,0001,0002,0268,
01139, FEIJÓ ,0007,1244,0072,0107,0023,0127,0088,0330,0215,0001,0007,0223,
01139, FEIJÓ ,0007,1295,0073,0038,0010,0073,0028,0140,0101,0000,0001,0102,
01139, FEIJÓ ,0007,1279,0076,0095,0002,0079,0021,0196,0100,0000,0001,0101,
01139, FEIJÓ ,0007,1171,0078,0103,0006,0082,0131,0323,0213,0004,0003,0220,
01139, FEIJÓ ,0007,1309,0079,0043,0002,0043,0075,0167,0118,0000,0006,0124,
01139, FEIJÓ ,0007,1163,0080,0114,0001,0101,0100,0318,0201,0001,0002,0204,
01139, FEIJÓ ,0007,1171,0081,0120,0017,0081,0139,0342,0220,0000,0002,0222,
01139, FEIJÓ ,0007,1244,0082,0089,0014,0138,0092,0325,0230,0002,0004,0236,
01139, FEIJÓ ,0007,1317,0083,0114,0000,0120,0024,0262,0144,0000,0004,0148,
01139, FEIJÓ ,0007,1163,0084,0116,0005,0087,0091,0300,0178,0002,0004,0184,
01139, FEIJÓ ,0007,1171,0085,0108,0008,0084,0110,0308,0194,0001,0005,0200,
01139, FEIJÓ ,0007,1180,0086,0111,0008,0122,0069,0306,0191,0000,0004,0195,
01139, FEIJÓ ,0007,1171,0087,0131,0017,0072,0103,0311,0175,0002,0003,0180,
01139, FEIJÓ ,0007,1244,0088,0107,0011,0122,0091,0322,0213,0001,0001,0215,
01139, FEIJÓ ,0007,1163,0089,0120,0014,0092,0084,0302,0176,0000,0006,0182,
01139, FEIJÓ ,0007,1333,0090,0024,0002,0031,0025,0081,0056,0001,0000,0057,
01392, RIO BRANCO ,0001,1279,0003,0038,0009,0048,0096,0185,0144,0002,0001,0147,
01392, RIO BRANCO ,0001,1139,0004,0080,0013,0083,0167,0339,0250,0002,0007,0259,
01392, RIO BRANCO ,0001,1031,0005,0081,0008,0072,0183,0341,0255,0003,0002,0260,
01392, RIO BRANCO ,0001,1031,0006,0098,0007,0072,0168,0343,0240,0001,0004,0245,
01392, RIO BRANCO ,0001,2321,0007,0077,0013,0083,0192,0357,0275,0000,0005,0280,
01392, RIO BRANCO ,0001,1031,0008,0094,0013,0061,0166,0335,0227,0005,0009,0241,
01392, RIO BRANCO ,0001,1058,0009,0076,0005,0069,0132,0283,0201,0003,0003,0207,
01392, RIO BRANCO ,0001,1090,0010,0050,0009,0064,0128,0250,0192,0002,0006,0200,
01392, RIO BRANCO ,0001,1066,0012,0089,0004,0048,0100,0241,0148,0002,0002,0152,
01392, RIO BRANCO ,0001,1961,0013,0050,0012,0071,0199,0331,0270,0004,0007,0281,
01392, RIO BRANCO ,0001,1074,0014,0068,0009,0054,0118,0245,0172,0001,0004,0177,
01392, RIO BRANCO ,0001,1090,0015,0050,0004,0066,0125,0248,0191,0001,0006,0198,
01392, RIO BRANCO ,0001,1090,0023,0045,0008,0069,0121,0247,0190,0008,0004,0202,
01392, RIO BRANCO ,0001,1074,0024,0066,0011,0052,0121,0246,0173,0004,0003,0180,
01392, RIO BRANCO ,0001,1031,0025,0097,0009,0072,0164,0343,0236,0005,0005,0246,
01392, RIO BRANCO ,0001,1708,0026,0051,0005,0036,0107,0197,0143,0000,0003,0146,
01392, RIO BRANCO ,0001,1031,0027,0081,0009,0075,0172,0336,0247,0005,0003,0255,
01392, RIO BRANCO ,0001,1090,0028,0083,0007,0060,0116,0267,0176,0002,0006,0184,
01392, RIO BRANCO ,0001,1090,0029,0064,0016,0060,0115,0247,0175,0003,0005,0183,
01392, RIO BRANCO ,0001,1066,0030,0069,0010,0061,0110,0246,0171,0003,0003,0177,
01392, RIO BRANCO ,0001,1066,0031,0088,0006,0044,0101,0236,0145,0003,0000,0148,
01392, RIO BRANCO ,0001,1180,0032,0038,0008,0039,0090,0171,0129,0000,0004,0133,
01392, RIO BRANCO ,0001,1988,0034,0036,0010,0043,0097,0178,0140,0001,0001,0142,
01392, RIO BRANCO ,0001,1317,0035,0081,0007,0079,0170,0333,0249,0001,0002,0252,
01392, RIO BRANCO ,0001,1139,0036,0091,0004,0068,0170,0340,0238,0003,0008,0249,
01392, RIO BRANCO ,0001,1139,0037,0079,0003,0063,0177,0327,0240,0002,0006,0248,
01392, RIO BRANCO ,0001,1139,0038,0087,0011,0072,0163,0333,0235,0002,0009,0246,
01392, RIO BRANCO ,0001,1317,0039,0048,0011,0048,0094,0195,0142,0001,0004,0147,
01392, RIO BRANCO ,0001,1317,0040,0045,0015,0036,0111,0200,0147,0003,0005,0155,
01392, RIO BRANCO ,0001,1180,0041,0026,0008,0046,0099,0174,0145,0002,0001,0148,
01392, RIO BRANCO ,0001,1180,0042,0045,0008,0045,0085,0178,0130,0002,0001,0133,
01392, RIO BRANCO ,0001,1074,0043,0077,0007,0049,0122,0251,0171,0000,0003,0174,
01392, RIO BRANCO ,0001,1694,0045,0061,0015,0070,0104,0243,0174,0003,0005,0182,
01392, RIO BRANCO ,0001,1279,0046,0066,0003,0053,0126,0254,0179,0003,0006,0188,
01392, RIO BRANCO ,0001,1848,0047,0065,0003,0052,0112,0238,0164,0007,0002,0173,
01392, RIO BRANCO ,0001,1171,0050,0055,0012,0053,0143,0255,0196,0001,0003,0200,
01392, RIO BRANCO ,0001,1171,0051,0060,0007,0039,0148,0252,0187,0003,0002,0192,
01392, RIO BRANCO ,0001,1180,0052,0029,0010,0048,0090,0177,0138,0004,0006,0148,
01392, RIO BRANCO ,0001,1236,0062,0068,0009,0057,0141,0275,0198,0003,0006,0207,
01392, RIO BRANCO ,0001,1236,0063,0075,0006,0065,0130,0274,0195,0002,0002,0199,
01392, RIO BRANCO ,0001,1236,0064,0058,0004,0056,0150,0272,0206,0003,0005,0214,
01392, RIO BRANCO ,0001,1236,0065,0078,0006,0041,0140,0267,0181,0004,0004,0189,
01392, RIO BRANCO ,0001,1260,0066,0047,0012,0056,0135,0245,0191,0001,0006,0198,
01392, RIO BRANCO ,0001,1236,0067,0067,0012,0050,0155,0278,0205,0003,0003,0211,
01392, RIO BRANCO ,0001,1260,0075,0058,0005,0046,0141,0257,0187,0005,0007,0199,
01392, RIO BRANCO ,0001,1260,0076,0045,0013,0052,0150,0255,0202,0003,0005,0210,
01392, RIO BRANCO ,0001,1279,0077,0039,0009,0046,0104,0195,0150,0003,0003,0156,
01392, RIO BRANCO ,0001,1295,0083,0081,0006,0054,0154,0298,0208,0005,0004,0217,
01392, RIO BRANCO ,0001,1295,0084,0077,0010,0041,0167,0290,0208,0003,0002,0213,
01392, RIO BRANCO ,0001,1295,0085,0072,0010,0049,0172,0294,0221,0000,0001,0222,
01392, RIO BRANCO ,0001,1295,0086,0098,0003,0046,0135,0288,0181,0002,0007,0190,
01392, RIO BRANCO ,0001,2402,0087,0065,0008,0039,0160,0271,0199,0001,0006,0206,
01392, RIO BRANCO ,0001,2402,0088,0057,0005,0063,0146,0271,0209,0002,0003,0214,
01392, RIO BRANCO ,0001,2402,0089,0065,0008,0058,0143,0271,0201,0002,0003,0206,
01392, RIO BRANCO ,0001,2402,0090,0071,0010,0045,0148,0270,0193,0002,0004,0199,
01392, RIO BRANCO ,0001,1317,0093,0048,0015,0046,0109,0207,0155,0002,0002,0159,
01392, RIO BRANCO ,0001,1317,0094,0041,0014,0055,0101,0201,0156,0000,0004,0160,
01392, RIO BRANCO ,0001,1325,0095,0102,0007,0080,0147,0336,0227,0004,0003,0234,
01392, RIO BRANCO ,0001,1325,0096,0088,0016,0072,0171,0338,0243,0001,0006,0250,
01392, RIO BRANCO ,0001,2569,0097,0063,0020,0046,0136,0252,0182,0003,0004,0189,
01392, RIO BRANCO ,0001,2569,0098,0074,0012,0055,0114,0249,0169,0001,0005,0175,
01392, RIO BRANCO ,0001,2569,0099,0059,0010,0057,0136,0254,0193,0001,0001,0195,
01392, RIO BRANCO ,0001,1589,0100,0051,0010,0041,0113,0208,0154,0001,0002,0157,
01392, RIO BRANCO ,0001,1384,0129,0070,0009,0083,0178,0337,0261,0003,0003,0267,
01392, RIO BRANCO ,0001,1384,0130,0071,0006,0083,0182,0341,0265,0003,0002,0270,
01392, RIO BRANCO ,0001,2461,0146,0049,0009,0057,0136,0245,0193,0001,0002,0196,
01392, RIO BRANCO ,0001,2828,0147,0068,0006,0050,0109,0237,0159,0008,0002,0169,
01392, RIO BRANCO ,0001,2828,0148,0051,0014,0063,0114,0233,0177,0001,0004,0182,
01392, RIO BRANCO ,0001,1066,0151,0091,0017,0044,0104,0243,0148,0003,0001,0152,
01392, RIO BRANCO ,0001,1465,0158,0048,0011,0090,0184,0335,0274,0006,0007,0287,
01392, RIO BRANCO ,0001,1465,0159,0051,0009,0080,0200,0340,0280,0006,0003,0289,
01392, RIO BRANCO ,0001,1473,0160,0073,0004,0071,0151,0297,0222,0001,0001,0224,
01392, RIO BRANCO ,0001,1473,0161,0076,0006,0077,0131,0292,0208,0004,0004,0216,
01392, RIO BRANCO ,0001,1708,0162,0054,0011,0048,0096,0200,0144,0001,0001,0146,
01392, RIO BRANCO ,0001,1490,0163,0052,0008,0039,0103,0200,0142,0004,0002,0148,
01392, RIO BRANCO ,0001,2100,0164,0057,0024,0056,0123,0243,0179,0004,0003,0186,
01392, RIO BRANCO ,0001,1546,0168,0048,0010,0078,0185,0319,0263,0001,0007,0271,
01392, RIO BRANCO ,0001,1554,0169,0044,0013,0060,0137,0250,0197,0002,0007,0206,
01392, RIO BRANCO ,0001,1490,0171,0042,0007,0039,0113,0199,0152,0003,0002,0157,
01392, RIO BRANCO ,0001,1490,0172,0076,0002,0109,0156,0348,0265,0004,0003,0272,
01392, RIO BRANCO ,0001,1317,0173,0050,0005,0047,0091,0193,0138,0000,0005,0143,
01392, RIO BRANCO ,0001,1872,0174,0089,0009,0068,0173,0334,0241,0002,0002,0245,
01392, RIO BRANCO ,0001,1600,0176,0033,0005,0054,0157,0250,0211,0002,0004,0217,
01392, RIO BRANCO ,0001,1589,0178,0044,0011,0043,0105,0196,0148,0002,0002,0152,
01392, RIO BRANCO ,0001,1589,0179,0037,0012,0046,0112,0201,0158,0002,0004,0164,
01392, RIO BRANCO ,0001,1643,0182,0069,0010,0064,0191,0331,0255,0003,0004,0262,
01392, RIO BRANCO ,0001,1643,0183,0073,0018,0065,0194,0336,0259,0001,0003,0263,
01392, RIO BRANCO ,0001,1643,0184,0064,0012,0060,0196,0328,0256,0004,0004,0264,
01392, RIO BRANCO ,0001,1651,0185,0037,0011,0064,0121,0227,0185,0003,0002,0190,
01392, RIO BRANCO ,0001,1066,0186,0077,0013,0047,0121,0250,0168,0004,0001,0173,
01392, RIO BRANCO ,0001,1066,0187,0053,0012,0054,0164,0277,0218,0003,0003,0224,
01392, RIO BRANCO ,0001,1694,0189,0056,0010,0058,0124,0241,0182,0002,0001,0185,
01392, RIO BRANCO ,0001,1694,0190,0056,0005,0057,0118,0236,0175,0002,0003,0180,
01392, RIO BRANCO ,0001,1694,0191,0058,0011,0059,0116,0237,0175,0002,0002,0179,
01392, RIO BRANCO ,0001,2500,0192,0041,0012,0046,0085,0176,0131,0002,0002,0135,
01392, RIO BRANCO ,0001,2500,0193,0039,0021,0043,0096,0181,0139,0001,0002,0142,
01392, RIO BRANCO ,0001,1708,0194,0047,0013,0047,0098,0197,0145,0003,0002,0150,
01392, RIO BRANCO ,0001,1783,0204,0065,0008,0024,0105,0194,0129,0000,0000,0129,
01392, RIO BRANCO ,0001,1783,0205,0053,0022,0022,0110,0188,0132,0000,0003,0135,
01392, RIO BRANCO ,0001,1783,0206,0067,0013,0026,0098,0195,0124,0003,0001,0128,
01392, RIO BRANCO ,0001,1694,0248,0028,0006,0082,0121,0238,0203,0004,0003,0210,
01392, RIO BRANCO ,0001,1236,0249,0057,0009,0057,0155,0270,0212,0001,0000,0213,
01392, RIO BRANCO ,0001,1090,0250,0038,0005,0072,0127,0245,0199,0002,0006,0207,
01392, RIO BRANCO ,0001,1856,0261,0091,0003,0063,0164,0323,0227,0004,0001,0232,
01392, RIO BRANCO ,0001,1872,0263,0060,0008,0064,0181,0312,0245,0004,0003,0252,
01392, RIO BRANCO ,0001,1279,0264,0037,0004,0040,0102,0187,0142,0002,0006,0150,
01392, RIO BRANCO ,0001,1929,0268,0056,0009,0057,0177,0300,0234,0003,0007,0244,
01392, RIO BRANCO ,0001,1848,0270,0064,0012,0054,0161,0282,0215,0003,0000,0218,
01392, RIO BRANCO ,0001,1139,0271,0098,0006,0064,0163,0330,0227,0000,0005,0232,
01392, RIO BRANCO ,0001,1031,0272,0098,0006,0064,0164,0335,0228,0005,0004,0237,
01392, RIO BRANCO ,0001,1074,0273,0069,0009,0052,0122,0246,0174,0002,0001,0177,
01392, RIO BRANCO ,0001,1279,0275,0038,0002,0043,0095,0182,0138,0002,0004,0144,
01392, RIO BRANCO ,0001,1473,0277,0069,0002,0077,0139,0294,0216,0005,0004,0225,
01392, RIO BRANCO ,0001,1490,0278,0066,0006,0088,0181,0348,0269,0005,0008,0282,
01392, RIO BRANCO ,0001,1988,0280,0023,0002,0045,0102,0177,0147,0003,0004,0154,
01392, RIO BRANCO ,0001,1708,0281,0045,0003,0030,0117,0195,0147,0000,0003,0150,
01392, RIO BRANCO ,0001,1651,0287,0039,0008,0054,0119,0222,0173,0005,0005,0183,
01392, RIO BRANCO ,0001,2054,0288,0087,0011,0070,0184,0355,0254,0005,0009,0268,
01392, RIO BRANCO ,0001,2089,0299,0076,0013,0074,0173,0326,0247,0001,0002,0250,
01392, RIO BRANCO ,0001,1988,0303,0029,0006,0050,0094,0177,0144,0001,0003,0148,
01392, RIO BRANCO ,0001,2100,0308,0047,0011,0059,0100,0214,0159,0004,0004,0167,
01392, RIO BRANCO ,0001,1996,0310,0088,0008,0039,0195,0328,0234,0004,0002,0240,
01392, RIO BRANCO ,0001,1759,0316,0050,0038,0045,0181,0279,0226,0001,0002,0229,
01392, RIO BRANCO ,0001,1856,0321,0100,0005,0074,0151,0329,0225,0001,0003,0229,
01392, RIO BRANCO ,0001,2615,0327,0040,0004,0057,0127,0229,0184,0002,0003,0189,
01392, RIO BRANCO ,0001,2089,0330,0080,0004,0065,0182,0333,0247,0003,0003,0253,
01392, RIO BRANCO ,0001,1260,0335,0047,0002,0052,0150,0255,0202,0001,0005,0208,
01392, RIO BRANCO ,0001,1856,0337,0078,0013,0072,0161,0320,0233,0003,0006,0242,
01392, RIO BRANCO ,0001,1171,0347,0055,0006,0049,0149,0258,0198,0004,0001,0203,
01392, RIO BRANCO ,0001,1554,0349,0041,0010,0052,0144,0243,0196,0001,0005,0202,
01392, RIO BRANCO ,0001,1600,0350,0041,0006,0069,0135,0249,0204,0002,0002,0208,
01392, RIO BRANCO ,0001,1872,0351,0072,0003,0063,0178,0319,0241,0003,0003,0247,
01392, RIO BRANCO ,0001,2089,0366,0087,0011,0063,0169,0324,0232,0003,0002,0237,
01392, RIO BRANCO ,0001,1546,0368,0063,0007,0076,0170,0319,0246,0004,0006,0256,
01392, RIO BRANCO ,0001,1317,0369,0039,0005,0045,0106,0193,0151,0001,0002,0154,
01392, RIO BRANCO ,0001,1171,0374,0049,0003,0047,0152,0252,0199,0001,0003,0203,
01392, RIO BRANCO ,0001,1465,0379,0039,0004,0098,0203,0345,0301,0003,0002,0306,
01392, RIO BRANCO ,0001,1473,0380,0060,0006,0079,0151,0294,0230,0002,0002,0234,
01392, RIO BRANCO ,0001,1694,0381,0028,0004,0062,0137,0234,0199,0004,0003,0206,
01392, RIO BRANCO ,0001,2526,0385,0081,0014,0066,0157,0310,0223,0001,0005,0229,
01392, RIO BRANCO ,0001,1872,0386,0075,0008,0065,0182,0328,0247,0003,0003,0253,
01392, RIO BRANCO ,0001,1996,0390,0073,0004,0052,0198,0332,0250,0005,0004,0259,
01392, RIO BRANCO ,0001,2054,0391,0065,0012,0066,0204,0344,0270,0004,0005,0279,
01392, RIO BRANCO ,0001,2313,0398,0071,0010,0055,0205,0334,0260,0002,0001,0263,
01392, RIO BRANCO ,0001,1384,0400,0059,0005,0080,0178,0325,0258,0005,0003,0266,
01392, RIO BRANCO ,0001,1600,0401,0045,0004,0056,0137,0246,0193,0002,0006,0201,
01392, RIO BRANCO ,0001,2089,0406,0056,0005,0078,0193,0332,0271,0002,0003,0276,
01392, RIO BRANCO ,0001,2470,0416,0094,0013,0053,0181,0331,0234,0002,0001,0237,
01392, RIO BRANCO ,0001,2755,0419,0036,0006,0038,0116,0199,0154,0004,0005,0163,
01392, RIO BRANCO ,0001,2569,0422,0059,0004,0052,0158,0282,0210,0005,0008,0223,
01392, RIO BRANCO ,0001,2526,0426,0082,0011,0054,0170,0313,0224,0001,0006,0231,
01392, RIO BRANCO ,0001,1708,0429,0030,0003,0045,0115,0195,0160,0002,0003,0165,
01392, RIO BRANCO ,0001,2577,0434,0097,0013,0050,0182,0332,0232,0001,0002,0235,
01392, RIO BRANCO ,0001,2585,0435,0081,0004,0058,0172,0319,0230,0005,0003,0238,
01392, RIO BRANCO ,0001,1929,0436,0053,0006,0078,0182,0317,0260,0001,0003,0264,
01392, RIO BRANCO ,0001,2313,0437,0083,0013,0046,0197,0329,0243,0001,0002,0246,
01392, RIO BRANCO ,0001,2470,0438,0086,0003,0057,0168,0314,0225,0001,0002,0228,
01392, RIO BRANCO ,0001,1295,0439,0072,0009,0054,0160,0287,0214,0001,0000,0215,
01392, RIO BRANCO ,0001,1996,0440,0094,0003,0048,0179,0326,0227,0002,0003,0232,
01392, RIO BRANCO ,0001,2550,0441,0073,0006,0053,0154,0284,0207,0002,0002,0211,
01392, RIO BRANCO ,0001,2542,0442,0089,0009,0064,0178,0335,0242,0002,0002,0246,
01392, RIO BRANCO ,0001,2534,0443,0061,0011,0064,0171,0299,0235,0001,0002,0238,
01392, RIO BRANCO ,0001,2054,0444,0061,0007,0057,0201,0327,0258,0003,0005,0266,
01392, RIO BRANCO ,0001,1848,0445,0083,0011,0035,0165,0295,0200,0002,0010,0212,
01392, RIO BRANCO ,0001,2313,0446,0084,0012,0043,0197,0329,0240,0003,0002,0245,
01392, RIO BRANCO ,0001,1996,0447,0093,0012,0051,0192,0342,0243,0002,0004,0249,
01392, RIO BRANCO ,0001,2470,0448,0083,0007,0053,0167,0310,0220,0004,0003,0227,
01392, RIO BRANCO ,0001,2577,0449,0097,0004,0044,0170,0322,0214,0006,0005,0225,
01392, RIO BRANCO ,0001,2526,0450,0091,0005,0065,0157,0317,0222,0000,0004,0226,
01392, RIO BRANCO ,0001,2585,0451,0097,0006,0054,0176,0330,0230,0000,0003,0233,
01392, RIO BRANCO ,0001,2542,0452,0081,0011,0051,0191,0330,0242,0004,0003,0249,
01392, RIO BRANCO ,0001,1929,0453,0070,0005,0057,0148,0281,0205,0003,0003,0211,
01392, RIO BRANCO ,0001,2569,0454,0052,0010,0051,0151,0258,0202,0003,0001,0206,
01392, RIO BRANCO ,0001,1783,0455,0047,0013,0027,0115,0192,0142,0002,0001,0145,
01392, RIO BRANCO ,0001,2666,0456,0057,0033,0057,0171,0291,0228,0005,0001,0234,
01392, RIO BRANCO ,0001,3174,0457,0089,0004,0048,0182,0323,0230,0003,0001,0234,
01392, RIO BRANCO ,0001,2550,0458,0077,0009,0051,0159,0292,0210,0002,0003,0215,
01392, RIO BRANCO ,0001,2674,0459,0080,0008,0046,0200,0332,0246,0003,0003,0252,
01392, RIO BRANCO ,0001,2542,0460,0078,0004,0048,0193,0325,0241,0001,0005,0247,
01392, RIO BRANCO ,0001,1872,0461,0073,0012,0059,0176,0313,0235,0003,0002,0240,
01392, RIO BRANCO ,0001,3174,0462,0083,0007,0057,0182,0329,0239,0003,0004,0246,
01392, RIO BRANCO ,0001,2720,0463,0078,0014,0058,0201,0342,0259,0000,0005,0264,
01392, RIO BRANCO ,0001,2690,0464,0092,0003,0046,0175,0317,0221,0002,0002,0225,
01392, RIO BRANCO ,0001,2577,0465,0084,0014,0061,0176,0330,0237,0005,0004,0246,
01392, RIO BRANCO ,0001,2550,0466,0072,0003,0055,0152,0280,0207,0000,0001,0208,
01392, RIO BRANCO ,0001,2054,0467,0092,0005,0066,0164,0330,0230,0003,0005,0238,
01392, RIO BRANCO ,0001,2674,0468,0093,0007,0048,0194,0339,0242,0003,0001,0246,
01392, RIO BRANCO ,0001,2720,0469,0085,0012,0045,0196,0330,0241,0003,0001,0245,
01392, RIO BRANCO ,0001,1295,0470,0075,0002,0061,0140,0279,0201,0002,0001,0204,
01392, RIO BRANCO ,0001,2313,0471,0103,0007,0038,0187,0333,0225,0002,0003,0230,
01392, RIO BRANCO ,0001,2720,0472,0088,0010,0044,0196,0333,0240,0002,0003,0245,
01392, RIO BRANCO ,0001,2712,0473,0075,0006,0038,0162,0276,0200,0001,0000,0201,
01392, RIO BRANCO ,0001,3174,0474,0091,0012,0054,0172,0325,0226,0006,0002,0234,
01392, RIO BRANCO ,0001,2470,0475,0101,0006,0056,0152,0317,0208,0006,0002,0216,
01392, RIO BRANCO ,0001,2690,0476,0076,0006,0047,0193,0322,0240,0004,0002,0246,
01392, RIO BRANCO ,0001,2488,0477,0078,0005,0050,0149,0284,0199,0002,0005,0206,
01392, RIO BRANCO ,0001,2542,0478,0093,0008,0047,0178,0327,0225,0005,0004,0234,
01392, RIO BRANCO ,0001,1708,0479,0049,0008,0044,0094,0196,0138,0004,0005,0147,
01392, RIO BRANCO ,0001,1856,0480,0092,0004,0061,0166,0324,0227,0004,0001,0232,
01392, RIO BRANCO ,0001,2666,0481,0074,0046,0046,0162,0287,0208,0003,0002,0213,
01392, RIO BRANCO ,0001,2569,0482,0071,0002,0041,0113,0229,0154,0001,0003,0158,
01392, RIO BRANCO ,0001,2674,0484,0090,0004,0056,0180,0335,0236,0004,0005,0245,
01392, RIO BRANCO ,0001,2542,0485,0111,0001,0043,0169,0328,0212,0002,0003,0217,
01392, RIO BRANCO ,0001,2798,0486,0118,0007,0029,0156,0309,0185,0001,0005,0191,
01392, RIO BRANCO ,0001,2763,0487,0070,0014,0045,0194,0316,0239,0005,0002,0246,
01392, RIO BRANCO ,0001,2780,0488,0075,0007,0040,0168,0285,0208,0000,0002,0210,
01392, RIO BRANCO ,0001,2771,0489,0042,0007,0049,0156,0253,0205,0003,0003,0211,
01392, RIO BRANCO ,0001,2801,0490,0078,0007,0048,0201,0333,0249,0001,0005,0255,
01392, RIO BRANCO ,0001,2690,0491,0092,0007,0049,0167,0313,0216,0002,0003,0221,
01392, RIO BRANCO ,0001,2585,0492,0090,0012,0056,0176,0336,0232,0007,0007,0246,
01392, RIO BRANCO ,0001,2542,0494,0101,0025,0053,0175,0334,0228,0002,0003,0233,
01392, RIO BRANCO ,0001,2836,0495,0124,0007,0051,0163,0342,0214,0001,0003,0218,
01392, RIO BRANCO ,0001,2828,0496,0060,0004,0056,0116,0236,0172,0003,0001,0176,
01392, RIO BRANCO ,0001,2810,0497,0063,0013,0040,0184,0289,0224,0001,0001,0226,
01392, RIO BRANCO ,0001,2844,0498,0106,0017,0053,0143,0313,0196,0006,0005,0207,
01392, RIO BRANCO ,0001,2712,0499,0081,0005,0059,0186,0333,0245,0005,0002,0252,
01392, RIO BRANCO ,0001,2534,0500,0044,0011,0034,0108,0190,0142,0004,0000,0146,
01392, RIO BRANCO ,0001,1929,0501,0089,0011,0045,0166,0306,0211,0001,0005,0217,
01392, RIO BRANCO ,0001,2852,0502,0060,0006,0032,0159,0255,0191,0002,0002,0195,
01392, RIO BRANCO ,0001,3174,0503,0088,0004,0069,0179,0340,0248,0002,0002,0252,
01392, RIO BRANCO ,0001,2860,0504,0092,0005,0034,0117,0246,0151,0002,0001,0154,
01392, RIO BRANCO ,0001,2720,0505,0101,0014,0040,0177,0323,0217,0002,0003,0222,
01392, RIO BRANCO ,0001,2690,0506,0094,0007,0046,0181,0325,0227,0001,0003,0231,
01392, RIO BRANCO ,0001,2836,0507,0138,0005,0054,0131,0328,0185,0003,0002,0190,
01392, RIO BRANCO ,0001,1848,0508,0072,0004,0034,0125,0231,0159,0000,0000,0159,
01392, RIO BRANCO ,0001,2712,0509,0090,0009,0036,0126,0255,0162,0002,0001,0165,
01392, RIO BRANCO ,0001,2801,0510,0097,0038,0052,0211,0366,0263,0004,0002,0269,
01392, RIO BRANCO ,0001,1759,0511,0047,0020,0031,0103,0185,0134,0003,0001,0138,
01392, RIO BRANCO ,0001,2810,0512,0082,0007,0046,0165,0296,0211,0003,0000,0214,
01392, RIO BRANCO ,0001,2798,0513,0112,0006,0054,0140,0314,0194,0003,0005,0202,
01392, RIO BRANCO ,0001,1066,0515,0101,0002,0038,0098,0242,0136,0002,0003,0141,
01392, RIO BRANCO ,0001,1066,0516,0110,0005,0037,0086,0239,0123,0000,0006,0129,
01392, RIO BRANCO ,0001,2763,0517,0051,0003,0026,0103,0183,0129,0003,0000,0132,
01392, RIO BRANCO ,0001,2895,0518,0110,0008,0071,0130,0320,0201,0002,0007,0210,
01392, RIO BRANCO ,0001,2550,0519,0063,0003,0029,0099,0193,0128,0002,0000,0130,
01392, RIO BRANCO ,0001,2909,0520,0056,0004,0034,0093,0183,0127,0000,0000,0127,
01392, RIO BRANCO ,0001,2917,0521,0046,0002,0029,0108,0191,0137,0004,0004,0145,
01392, RIO BRANCO ,0001,2950,0523,0073,0004,0021,0120,0218,0141,0001,0003,0145,
01392, RIO BRANCO ,0001,2933,0524,0106,0004,0064,0149,0324,0213,0002,0003,0218,
01392, RIO BRANCO ,0001,3026,0526,0079,0009,0053,0141,0282,0194,0004,0005,0203,
01392, RIO BRANCO ,0001,3093,0527,0092,0023,0041,0123,0263,0164,0003,0004,0171,
01392, RIO BRANCO ,0001,3018,0529,0087,0003,0063,0141,0300,0204,0001,0008,0213,
01392, RIO BRANCO ,0001,2968,0530,0083,0008,0052,0140,0278,0192,0002,0001,0195,
01392, RIO BRANCO ,0001,3034,0531,0098,0006,0033,0153,0295,0186,0007,0004,0197,
01392, RIO BRANCO ,0001,1929,0532,0053,0002,0043,0086,0183,0129,0000,0001,0130,
01392, RIO BRANCO ,0001,2054,0533,0065,0012,0069,0154,0296,0223,0007,0001,0231,
01392, RIO BRANCO ,0001,3042,0534,0105,0005,0057,0146,0315,0203,0005,0002,0210,
01392, RIO BRANCO ,0001,3050,0535,0120,0004,0049,0157,0330,0206,0002,0002,0210,
01392, RIO BRANCO ,0001,2976,0536,0041,0003,0046,0092,0186,0138,0004,0003,0145,
01392, RIO BRANCO ,0001,2917,0537,0071,0006,0032,0094,0199,0126,0001,0001,0128,
01392, RIO BRANCO ,0001,2860,0539,0041,0005,0027,0069,0139,0096,0002,0000,0098,
01392, RIO BRANCO ,0001,3000,0541,0080,0011,0058,0169,0312,0227,0002,0003,0232,
01392, RIO BRANCO ,0001,3115,0542,0083,0022,0049,0191,0325,0240,0002,0000,0242,
01392, RIO BRANCO ,0001,2550,0543,0063,0004,0037,0090,0195,0127,0001,0004,0132,
01392, RIO BRANCO ,0001,2771,0544,0058,0009,0044,0148,0251,0192,0001,0000,0193,
01392, RIO BRANCO ,0001,2895,0545,0094,0014,0078,0152,0335,0230,0004,0007,0241,
01392, RIO BRANCO ,0001,2895,0546,0118,0002,0066,0144,0333,0210,0002,0003,0215,
01392, RIO BRANCO ,0001,2780,0547,0067,0014,0048,0150,0269,0198,0004,0000,0202,
01392, RIO BRANCO ,0001,2798,0549,0118,0007,0047,0150,0319,0197,0002,0002,0201,
01392, RIO BRANCO ,0001,2909,0550,0056,0008,0040,0089,0186,0129,0001,0000,0130,
01392, RIO BRANCO ,0001,2763,0551,0066,0004,0036,0122,0227,0158,0003,0000,0161,
01392, RIO BRANCO ,0001,2054,0552,0087,0010,0059,0141,0293,0200,0003,0003,0206,
01392, RIO BRANCO ,0001,2810,0553,0086,0010,0038,0161,0290,0199,0002,0003,0204,
01392, RIO BRANCO ,0001,1643,0554,0098,0011,0057,0171,0335,0228,0004,0005,0237,
01392, RIO BRANCO ,0001,2712,0555,0091,0019,0043,0134,0270,0177,0001,0001,0179,
01392, RIO BRANCO ,0001,2569,0556,0041,0000,0045,0118,0208,0163,0002,0002,0167,
01392, RIO BRANCO ,0001,2666,0557,0070,0032,0059,0154,0286,0213,0001,0002,0216,
01392, RIO BRANCO ,0001,2550,0558,0057,0002,0038,0098,0195,0136,0002,0000,0138,
01392, RIO BRANCO ,0001,1929,0559,0045,0003,0041,0088,0178,0129,0001,0003,0133,
01392, RIO BRANCO ,0001,2534,0560,0054,0007,0031,0104,0190,0135,0001,0000,0136,
01392, RIO BRANCO ,0001,1848,0561,0109,0004,0034,0091,0237,0125,0000,0003,0128,
01392, RIO BRANCO ,0001,2801,0562,0096,0006,0055,0177,0336,0232,0004,0004,0240,
01392, RIO BRANCO ,0001,3034,0564,0076,0004,0046,0164,0292,0210,0003,0003,0216,
01392, RIO BRANCO ,0001,3247,0565,0062,0010,0049,0108,0223,0157,0002,0002,0161,
01392, RIO BRANCO ,0001,3247,0566,0069,0016,0056,0139,0272,0195,0004,0004,0203,
01392, RIO BRANCO ,0001,3247,0567,0065,0006,0065,0164,0300,0229,0002,0004,0235,
01392, RIO BRANCO ,0001,3247,0568,0069,0012,0060,0164,0307,0224,0003,0011,0238,
01392, RIO BRANCO ,0001,3255,0569,0060,0012,0097,0172,0337,0269,0003,0005,0277,
01392, RIO BRANCO ,0001,3255,0570,0067,0005,0083,0179,0343,0262,0005,0009,0276,
01392, RIO BRANCO ,0001,3255,0571,0056,0005,0091,0181,0337,0272,0003,0006,0281,
01392, RIO BRANCO ,0001,3255,0572,0043,0009,0089,0191,0333,0280,0006,0004,0290,
01392, RIO BRANCO ,0001,3263,0573,0072,0009,0064,0185,0328,0249,0005,0002,0256,
01392, RIO BRANCO ,0001,3263,0574,0086,0007,0066,0172,0337,0238,0005,0008,0251,
01392, RIO BRANCO ,0001,3280,0632,0083,0010,0073,0167,0332,0240,0003,0006,0249,
01392, RIO BRANCO ,0001,3280,0633,0078,0010,0077,0176,0336,0253,0001,0004,0258,
01392, RIO BRANCO ,0001,3280,0634,0087,0005,0071,0173,0332,0244,0000,0001,0245,
01392, RIO BRANCO ,0001,3280,0635,0075,0026,0092,0156,0338,0248,0008,0007,0263,
01392, RIO BRANCO ,0001,3280,0636,0104,0007,0086,0137,0333,0223,0002,0004,0229,
01392, RIO BRANCO ,0001,3298,0637,0082,0009,0074,0171,0337,0245,0004,0006,0255,
01392, RIO BRANCO ,0001,3298,0638,0075,0015,0064,0187,0336,0251,0003,0007,0261,
01392, RIO BRANCO ,0001,3298,0639,0086,0012,0067,0166,0330,0233,0004,0007,0244,
01392, RIO BRANCO ,0001,3298,0640,0074,0009,0079,0166,0332,0245,0005,0008,0258,
01392, RIO BRANCO ,0001,3298,0641,0086,0008,0062,0184,0339,0246,0003,0004,0253,
01392, RIO BRANCO ,0001,3301,0642,0080,0016,0074,0173,0336,0247,0004,0005,0256,
01392, RIO BRANCO ,0001,3301,0643,0073,0016,0063,0190,0333,0253,0002,0005,0260,
01392, RIO BRANCO ,0001,3301,0644,0085,0005,0058,0195,0341,0253,0002,0001,0256,
01392, RIO BRANCO ,0001,3310,0645,0075,0010,0077,0159,0319,0236,0003,0005,0244,
01392, RIO BRANCO ,0001,3310,0646,0081,0017,0070,0159,0323,0229,0004,0009,0242,
01392, RIO BRANCO ,0001,3310,0647,0066,0014,0078,0169,0319,0247,0001,0005,0253,
01392, RIO BRANCO ,0001,3310,0648,0080,0007,0067,0163,0322,0230,0003,0009,0242,
01392, RIO BRANCO ,0001,3328,0649,0069,0009,0061,0201,0335,0262,0002,0002,0266,
01392, RIO BRANCO ,0001,3328,0650,0066,0005,0056,0204,0339,0260,0006,0007,0273,
01392, RIO BRANCO ,0001,3328,0651,0069,0006,0050,0209,0335,0259,0004,0003,0266,
01392, RIO BRANCO ,0001,3328,0652,0067,0003,0054,0209,0334,0263,0001,0003,0267,
01392, RIO BRANCO ,0001,3328,0653,0083,0013,0052,0192,0334,0244,0005,0002,0251,
01392, RIO BRANCO ,0001,3336,0654,0079,0000,0057,0189,0330,0246,0001,0004,0251,
01392, RIO BRANCO ,0001,3336,0655,0082,0002,0057,0185,0335,0242,0005,0006,0253,
01392, RIO BRANCO ,0001,3336,0656,0082,0007,0079,0165,0334,0244,0001,0007,0252,
01392, RIO BRANCO ,0001,3344,0657,0080,0007,0059,0177,0320,0236,0002,0002,0240,
01392, RIO BRANCO ,0001,3344,0658,0072,0004,0056,0184,0318,0240,0002,0004,0246,
01392, RIO BRANCO ,0001,3344,0659,0096,0007,0058,0164,0324,0222,0003,0003,0228,
01392, RIO BRANCO ,0001,3344,0660,0092,0001,0049,0184,0330,0233,0002,0003,0238,
01392, RIO BRANCO ,0001,3352,0661,0066,0006,0071,0187,0332,0258,0005,0003,0266,
01392, RIO BRANCO ,0001,3352,0662,0068,0017,0084,0173,0334,0257,0005,0004,0266,
01392, RIO BRANCO ,0001,3352,0663,0071,0002,0061,0188,0324,0249,0000,0004,0253,
01392, RIO BRANCO ,0001,3352,0664,0080,0001,0078,0169,0333,0247,0002,0004,0253,
01392, RIO BRANCO ,0001,3360,0665,0071,0019,0089,0176,0343,0265,0003,0004,0272,
01392, RIO BRANCO ,0001,3360,0666,0069,0010,0072,0183,0333,0255,0001,0008,0264,
01392, RIO BRANCO ,0001,3360,0667,0061,0007,0067,0193,0336,0260,0006,0009,0275,
01392, RIO BRANCO ,0001,3360,0668,0068,0010,0087,0174,0342,0261,0008,0005,0274,
01392, RIO BRANCO ,0001,3360,0669,0077,0020,0083,0174,0343,0257,0004,0005,0266,
01392, RIO BRANCO ,0001,3379,0670,0092,0017,0075,0156,0332,0231,0005,0004,0240,
01392, RIO BRANCO ,0001,3379,0671,0093,0008,0067,0171,0341,0238,0001,0009,0248,
01392, RIO BRANCO ,0001,3379,0672,0087,0002,0082,0159,0332,0241,0002,0002,0245,
01392, RIO BRANCO ,0001,3379,0673,0085,0006,0087,0158,0336,0245,0003,0003,0251,
01392, RIO BRANCO ,0001,3379,0674,0082,0010,0061,0185,0333,0246,0002,0003,0251,
01392, RIO BRANCO ,0001,3379,0675,0082,0004,0055,0182,0331,0237,0005,0007,0249,
01392, RIO BRANCO ,0001,3387,0676,0061,0012,0057,0143,0276,0200,0002,0013,0215,
01392, RIO BRANCO ,0001,3387,0677,0070,0008,0074,0147,0299,0221,0001,0007,0229,
01392, RIO BRANCO ,0001,3395,0679,0059,0023,0057,0120,0243,0177,0003,0004,0184,
01392, RIO BRANCO ,0001,3395,0680,0050,0014,0058,0129,0242,0187,0001,0004,0192,
01392, RIO BRANCO ,0001,3395,0681,0044,0007,0053,0135,0239,0188,0002,0005,0195,
01392, RIO BRANCO ,0001,3409,0682,0068,0015,0064,0169,0306,0233,0000,0005,0238,
01392, RIO BRANCO ,0001,3425,0685,0079,0004,0073,0168,0322,0241,0000,0002,0243,
01392, RIO BRANCO ,0001,3425,0686,0091,0015,0064,0160,0321,0224,0003,0003,0230,
01392, RIO BRANCO ,0001,3425,0687,0107,0001,0041,0160,0312,0201,0002,0002,0205,
01392, RIO BRANCO ,0001,3425,0688,0116,0006,0044,0155,0320,0199,0001,0004,0204,
01392, RIO BRANCO ,0001,3433,0689,0077,0010,0084,0164,0331,0248,0003,0003,0254,
01392, RIO BRANCO ,0001,3433,0690,0073,0011,0079,0171,0332,0250,0005,0004,0259,
01392, RIO BRANCO ,0001,3441,0691,0062,0006,0043,0225,0335,0268,0003,0002,0273,
01392, RIO BRANCO ,0001,3441,0692,0076,0012,0057,0194,0335,0251,0004,0004,0259,
01392, RIO BRANCO ,0001,3441,0693,0085,0010,0061,0180,0332,0241,0002,0004,0247,
01392, RIO BRANCO ,0001,3450,0694,0087,0008,0082,0161,0342,0243,0001,0011,0255,
01392, RIO BRANCO ,0001,3468,0695,0069,0007,0076,0185,0340,0261,0008,0002,0271,
01392, RIO BRANCO ,0001,3468,0696,0074,0012,0059,0203,0345,0262,0003,0006,0271,
01392, RIO BRANCO ,0001,3468,0697,0072,0003,0068,0189,0333,0257,0000,0004,0261,
01392, RIO BRANCO ,0001,3468,0698,0070,0012,0070,0184,0334,0254,0005,0005,0264,
01392, RIO BRANCO ,0001,3468,0699,0081,0005,0059,0185,0334,0244,0005,0004,0253,
01392, RIO BRANCO ,0001,3468,0700,0083,0006,0061,0182,0336,0243,0006,0004,0253,
01392, RIO BRANCO ,0001,3611,0701,0036,0007,0056,0123,0221,0179,0004,0002,0185,
01392, RIO BRANCO ,0001,3611,0702,0037,0003,0049,0106,0197,0155,0001,0004,0160,
01392, RIO BRANCO ,0001,3611,0703,0041,0002,0045,0102,0194,0147,0002,0004,0153,
01392, RIO BRANCO ,0001,3611,0704,0041,0010,0049,0095,0193,0144,0004,0004,0152,
01392, RIO BRANCO ,0001,3310,0705,0071,0007,0081,0155,0317,0236,0006,0004,0246,
01392, RIO BRANCO ,0001,3492,0706,0053,0011,0078,0130,0268,0208,0005,0002,0215,
01392, RIO BRANCO ,0001,3492,0707,0057,0011,0055,0138,0253,0193,0001,0002,0196,
01392, RIO BRANCO ,0001,3492,0708,0053,0009,0050,0146,0254,0196,0004,0001,0201,
01392, RIO BRANCO ,0001,3492,0709,0074,0004,0050,0113,0245,0163,0002,0006,0171,
01392, RIO BRANCO ,0001,3506,0710,0065,0010,0066,0189,0329,0255,0002,0007,0264,
01392, RIO BRANCO ,0001,3506,0711,0067,0007,0054,0210,0338,0264,0001,0006,0271,
01392, RIO BRANCO ,0001,3506,0712,0069,0007,0056,0205,0341,0261,0004,0007,0272,
01392, RIO BRANCO ,0001,3506,0713,0084,0010,0047,0189,0330,0236,0004,0006,0246,
01392, RIO BRANCO ,0001,3514,0714,0033,0006,0050,0093,0185,0143,0004,0005,0152,
01392, RIO BRANCO ,0001,3522,0715,0065,0014,0064,0163,0303,0227,0003,0008,0238,
01392, RIO BRANCO ,0001,3522,0716,0055,0019,0084,0157,0305,0241,0005,0004,0250,
01392, RIO BRANCO ,0001,3522,0718,0117,0002,0049,0113,0294,0162,0006,0009,0177,
01392, RIO BRANCO ,0001,3549,0722,0059,0010,0077,0153,0294,0230,0004,0001,0235,
01392, RIO BRANCO ,0001,3549,0723,0061,0013,0084,0143,0294,0227,0003,0003,0233,
01392, RIO BRANCO ,0001,3549,0724,0074,0006,0077,0142,0299,0219,0001,0005,0225,
01392, RIO BRANCO ,0001,3557,0725,0070,0025,0049,0154,0280,0203,0003,0004,0210,
01392, RIO BRANCO ,0001,3557,0726,0080,0028,0043,0148,0281,0191,0006,0004,0201,
01392, RIO BRANCO ,0001,3565,0727,0096,0006,0067,0163,0335,0230,0003,0006,0239,
01392, RIO BRANCO ,0001,3565,0728,0114,0006,0061,0155,0336,0216,0000,0006,0222,
01392, RIO BRANCO ,0001,3573,0729,0099,0007,0064,0164,0334,0228,0004,0003,0235,
01392, RIO BRANCO ,0001,3573,0730,0088,0012,0063,0179,0338,0242,0004,0004,0250,
01392, RIO BRANCO ,0001,3573,0731,0088,0007,0068,0172,0333,0240,0003,0002,0245,
01392, RIO BRANCO ,0001,3581,0732,0075,0015,0062,0182,0327,0244,0003,0005,0252,
01392, RIO BRANCO ,0001,3581,0733,0058,0009,0078,0182,0327,0260,0005,0004,0269,
01392, RIO BRANCO ,0001,3581,0734,0073,0003,0071,0167,0314,0238,0001,0002,0241,
01392, RIO BRANCO ,0001,3581,0735,0100,0003,0061,0152,0323,0213,0005,0005,0223,
01392, RIO BRANCO ,0001,3590,0736,0072,0016,0070,0183,0336,0253,0003,0008,0264,
01392, RIO BRANCO ,0001,3590,0737,0063,0016,0063,0202,0339,0265,0006,0005,0276,
01392, RIO BRANCO ,0001,3590,0738,0062,0006,0070,0197,0335,0267,0004,0002,0273,
01392, RIO BRANCO ,0001,3590,0739,0060,0012,0066,0194,0334,0260,0006,0008,0274,
01392, RIO BRANCO ,0001,3603,0740,0067,0012,0069,0152,0299,0221,0004,0007,0232,
01392, RIO BRANCO ,0001,3603,0741,0070,0011,0069,0140,0290,0209,0002,0009,0220,
01392, RIO BRANCO ,0001,3611,0742,0050,0009,0054,0139,0253,0193,0003,0007,0203,
01392, RIO BRANCO ,0001,3611,0743,0070,0003,0041,0138,0255,0179,0002,0004,0185,
01392, RIO BRANCO ,0001,3620,0744,0055,0009,0061,0153,0270,0214,0001,0000,0215,
01392, RIO BRANCO ,0001,3620,0745,0058,0005,0062,0146,0271,0208,0002,0003,0213,
01392, RIO BRANCO ,0001,3638,0746,0072,0015,0084,0172,0332,0256,0003,0001,0260,
01392, RIO BRANCO ,0001,3638,0747,0070,0013,0073,0179,0333,0252,0008,0003,0263,
01392, RIO BRANCO ,0001,3638,0748,0061,0014,0080,0185,0330,0265,0002,0002,0269,
01392, RIO BRANCO ,0001,3646,0749,0078,0012,0080,0160,0332,0240,0010,0004,0254,
01392, RIO BRANCO ,0001,3646,0750,0082,0008,0083,0152,0327,0235,0002,0008,0245,
01392, RIO BRANCO ,0001,3646,0751,0064,0014,0064,0188,0326,0252,0003,0007,0262,
01392, RIO BRANCO ,0001,3689,0752,0062,0009,0073,0166,0309,0239,0001,0007,0247,
01392, RIO BRANCO ,0001,3689,0753,0054,0013,0071,0181,0317,0252,0006,0005,0263,
01392, RIO BRANCO ,0001,3689,0754,0064,0016,0064,0181,0318,0245,0002,0007,0254,
01392, RIO BRANCO ,0001,3638,0755,0073,0008,0086,0164,0330,0250,0002,0005,0257,
01392, RIO BRANCO ,0001,3662,0756,0062,0007,0061,0213,0342,0274,0000,0006,0280,
01392, RIO BRANCO ,0001,3662,0757,0044,0001,0045,0116,0212,0161,0003,0004,0168,
01392, RIO BRANCO ,0001,3670,0758,0042,0003,0047,0129,0227,0176,0005,0004,0185,
01392, RIO BRANCO ,0001,3670,0759,0063,0006,0048,0113,0232,0161,0005,0003,0169,
01392, RIO BRANCO ,0001,3670,0760,0052,0013,0047,0123,0232,0170,0004,0006,0180,
01392, RIO BRANCO ,0001,3670,0761,0055,0009,0055,0118,0234,0173,0000,0006,0179,
01392, RIO BRANCO ,0001,3689,0762,0034,0009,0040,0081,0159,0121,0001,0003,0125,
01392, RIO BRANCO ,0001,3697,0765,0078,0010,0066,0149,0301,0215,0005,0003,0223,
01392, RIO BRANCO ,0001,3700,0766,0073,0013,0074,0165,0316,0239,0001,0003,0243,
01392, RIO BRANCO ,0001,3700,0767,0080,0015,0068,0175,0325,0243,0002,0000,0245,
01392, RIO BRANCO ,0001,3700,0768,0085,0013,0065,0165,0321,0230,0005,0001,0236,
01392, RIO BRANCO ,0001,3700,0769,0069,0002,0072,0161,0314,0233,0004,0008,0245,
01392, RIO BRANCO ,0001,3700,0770,0087,0013,0051,0166,0313,0217,0003,0006,0226,
01392, RIO BRANCO ,0001,3719,0771,0094,0011,0081,0156,0340,0237,0004,0005,0246,
01392, RIO BRANCO ,0001,3492,0772,0054,0004,0059,0124,0241,0183,0002,0002,0187,
01392, RIO BRANCO ,0001,3492,0773,0038,0010,0068,0128,0240,0196,0003,0003,0202,
01392, RIO BRANCO ,0001,3735,0774,0062,0009,0073,0192,0335,0265,0003,0005,0273,
01392, RIO BRANCO ,0001,3735,0775,0065,0005,0089,0159,0329,0248,0007,0009,0264,
01392, RIO BRANCO ,0001,3735,0776,0075,0006,0087,0166,0338,0253,0007,0003,0263,
01392, RIO BRANCO ,0001,3735,0777,0077,0010,0067,0186,0337,0253,0003,0004,0260,
01392, RIO BRANCO ,0001,3743,0778,0048,0006,0066,0209,0326,0275,0001,0002,0278,
01392, RIO BRANCO ,0001,3743,0779,0072,0008,0040,0206,0327,0246,0002,0007,0255,
01392, RIO BRANCO ,0001,3743,0780,0072,0006,0059,0189,0331,0248,0004,0007,0259,
01392, RIO BRANCO ,0001,3743,0781,0066,0008,0058,0201,0329,0259,0001,0003,0263,
01392, RIO BRANCO ,0001,3751,0782,0056,0007,0067,0211,0340,0278,0004,0002,0284,
01392, RIO BRANCO ,0001,3751,0783,0082,0005,0077,0163,0328,0240,0002,0004,0246,
01392, RIO BRANCO ,0001,3751,0784,0090,0005,0058,0179,0335,0237,0003,0005,0245,
01392, RIO BRANCO ,0001,3751,0785,0092,0003,0071,0168,0338,0239,0003,0004,0246,
01392, RIO BRANCO ,0001,3751,0786,0109,0008,0065,0158,0341,0223,0007,0002,0232,
01392, RIO BRANCO ,0001,3751,0787,0074,0008,0065,0187,0340,0252,0009,0005,0266,
01392, RIO BRANCO ,0001,3336,0788,0113,0005,0067,0153,0338,0220,0002,0003,0225,
01392, RIO BRANCO ,0001,2895,0789,0113,0014,0069,0154,0342,0223,0003,0003,0229,
01392, RIO BRANCO ,0001,3573,0790,0094,0000,0072,0162,0337,0234,0004,0005,0243,
01392, RIO BRANCO ,0001,2933,0791,0097,0015,0054,0170,0327,0224,0003,0003,0230,
01392, RIO BRANCO ,0001,3751,0792,0085,0006,0078,0169,0335,0247,0003,0000,0250,
01392, RIO BRANCO ,0001,2852,0793,0059,0007,0049,0104,0215,0153,0002,0001,0156,
01392, RIO BRANCO ,0001,2844,0794,0100,0016,0064,0145,0314,0209,0000,0005,0214,
01392, RIO BRANCO ,0001,2968,0795,0080,0007,0041,0154,0276,0195,0000,0001,0196,
01392, RIO BRANCO ,0001,2810,0796,0097,0006,0055,0136,0293,0191,0001,0004,0196,
01392, RIO BRANCO ,0001,2895,0798,0114,0007,0078,0139,0334,0217,0001,0002,0220,
01392, RIO BRANCO ,0001,3751,0800,0081,0009,0061,0173,0328,0234,0007,0006,0247,
01392, RIO BRANCO ,0001,3042,0801,0114,0016,0045,0161,0326,0206,0005,0001,0212,
01392, RIO BRANCO ,0001,3549,0802,0080,0011,0081,0133,0300,0214,0004,0002,0220,
01392, RIO BRANCO ,0001,1996,0803,0140,0009,0039,0154,0337,0193,0003,0001,0197,
01392, RIO BRANCO ,0001,1872,0804,0075,0002,0058,0124,0261,0182,0004,0000,0186,
01392, RIO BRANCO ,0001,3247,0805,0080,0010,0061,0142,0293,0203,0003,0007,0213,
01392, RIO BRANCO ,0001,3336,0806,0102,0006,0062,0167,0339,0229,0005,0003,0237,
01392, RIO BRANCO ,0001,3697,0807,0076,0001,0038,0095,0215,0133,0004,0002,0139,
01392, RIO BRANCO ,0001,3034,0808,0074,0008,0038,0138,0258,0176,0003,0005,0184,
01392, RIO BRANCO ,0001,3026,0809,0059,0006,0043,0078,0185,0121,0003,0002,0126,
01392, RIO BRANCO ,0001,2712,0810,0070,0005,0040,0121,0236,0161,0003,0002,0166,
01392, RIO BRANCO ,0001,1643,0811,0104,0009,0059,0169,0341,0228,0000,0009,0237,
01392, RIO BRANCO ,0001,3506,0812,0112,0004,0067,0155,0339,0222,0004,0001,0227,
01392, RIO BRANCO ,0001,3433,0813,0098,0010,0081,0150,0342,0231,0006,0007,0244,
01392, RIO BRANCO ,0001,3778,0814,0110,0009,0076,0144,0339,0220,0004,0005,0229,
01392, RIO BRANCO ,0001,3786,0815,0038,0002,0043,0066,0150,0109,0001,0002,0112,
01392, RIO BRANCO ,0001,3093,0816,0039,0013,0026,0111,0178,0137,0002,0000,0139,
01392, RIO BRANCO ,0001,2780,0818,0029,0003,0038,0072,0142,0110,0001,0002,0113,
01392, RIO BRANCO ,0001,3468,0820,0069,0002,0097,0174,0346,0271,0003,0003,0277,
01392, RIO BRANCO ,0001,2313,0821,0054,0003,0075,0207,0337,0282,0001,0000,0283,
01392, RIO BRANCO ,0001,3425,0822,0075,0002,0077,0152,0308,0229,0002,0002,0233,
01392, RIO BRANCO ,0001,2470,0823,0072,0008,0057,0178,0314,0235,0006,0001,0242,
01392, RIO BRANCO ,0001,3344,0824,0076,0006,0064,0180,0332,0244,0007,0005,0256,
01392, RIO BRANCO ,0001,3743,0826,0083,0008,0069,0179,0334,0248,0001,0002,0251,
01392, RIO BRANCO ,0001,2690,0827,0032,0004,0034,0110,0180,0144,0004,0000,0148,
01392, RIO BRANCO ,0001,3778,0829,0090,0003,0102,0143,0343,0245,0005,0003,0253,
01392, RIO BRANCO ,0001,3840,0834,0054,0003,0059,0189,0305,0248,0001,0002,0251,
01392, RIO BRANCO ,0001,3581,0835,0028,0003,0051,0096,0182,0147,0007,0000,0154,
01392, RIO BRANCO ,0009,1350,0011,0051,0007,0056,0143,0253,0199,0000,0003,0202,
01392, RIO BRANCO ,0009,1350,0012,0045,0009,0066,0126,0247,0192,0003,0007,0202,
01392, RIO BRANCO ,0009,1643,0013,0074,0013,0054,0099,0234,0153,0005,0002,0160,
01392, RIO BRANCO ,0009,1368,0014,0065,0007,0068,0195,0341,0263,0004,0009,0276,
01392, RIO BRANCO ,0009,1368,0015,0065,0006,0079,0182,0340,0261,0005,0009,0275,
01392, RIO BRANCO ,0009,1570,0016,0068,0004,0063,0198,0339,0261,0003,0007,0271,
01392, RIO BRANCO ,0009,1570,0017,0069,0011,0071,0194,0340,0265,0003,0003,0271,
01392, RIO BRANCO ,0009,1031,0018,0069,0011,0078,0178,0336,0256,0006,0005,0267,
01392, RIO BRANCO ,0009,1031,0019,0073,0028,0070,0185,0335,0255,0003,0004,0262,
01392, RIO BRANCO ,0009,1422,0020,0065,0017,0083,0215,0375,0298,0001,0011,0310,
01392, RIO BRANCO ,0009,1376,0021,0064,0006,0075,0184,0331,0259,0002,0006,0267,
01392, RIO BRANCO ,0009,1376,0022,0059,0007,0074,0191,0333,0265,0003,0006,0274,
01392, RIO BRANCO ,0009,1384,0023,0069,0016,0060,0203,0341,0263,0000,0009,0272,
01392, RIO BRANCO ,0009,1384,0024,0075,0013,0065,0190,0339,0255,0004,0005,0264,
01392, RIO BRANCO ,0009,1058,0025,0075,0008,0068,0182,0336,0250,0005,0006,0261,
01392, RIO BRANCO ,0009,1058,0026,0071,0013,0062,0195,0334,0257,0001,0005,0263,
01392, RIO BRANCO ,0009,1058,0027,0064,0020,0063,0200,0337,0263,0001,0009,0273,
01392, RIO BRANCO ,0009,1171,0028,0051,0002,0053,0121,0234,0174,0004,0005,0183,
01392, RIO BRANCO ,0009,1406,0029,0059,0004,0044,0161,0277,0205,0003,0010,0218,
01392, RIO BRANCO ,0009,1066,0030,0084,0011,0068,0195,0354,0263,0002,0005,0270,
01392, RIO BRANCO ,0009,1066,0031,0082,0015,0056,0210,0356,0266,0004,0004,0274,
01392, RIO BRANCO ,0009,1457,0032,0039,0001,0054,0133,0233,0187,0001,0006,0194,
01392, RIO BRANCO ,0009,1449,0033,0061,0006,0070,0199,0338,0269,0004,0004,0277,
01392, RIO BRANCO ,0009,1457,0034,0034,0006,0047,0139,0229,0186,0003,0006,0195,
01392, RIO BRANCO ,0009,1040,0035,0074,0009,0055,0191,0333,0246,0006,0007,0259,
01392, RIO BRANCO ,0009,1074,0036,0075,0019,0071,0176,0333,0247,0005,0006,0258,
01392, RIO BRANCO ,0009,1074,0037,0082,0015,0063,0185,0335,0248,0002,0003,0253,
01392, RIO BRANCO ,0009,1074,0038,0068,0017,0067,0194,0337,0261,0004,0004,0269,
01392, RIO BRANCO ,0009,1155,0039,0061,0009,0043,0115,0224,0158,0001,0004,0163,
01392, RIO BRANCO ,0009,1503,0040,0039,0012,0056,0130,0233,0186,0003,0005,0194,
01392, RIO BRANCO ,0009,1074,0041,0079,0007,0061,0194,0339,0255,0000,0005,0260,
01392, RIO BRANCO ,0009,1996,0042,0079,0018,0055,0138,0279,0193,0004,0003,0200,
01392, RIO BRANCO ,0009,1490,0043,0072,0011,0097,0182,0362,0279,0004,0007,0290,
01392, RIO BRANCO ,0009,1490,0044,0059,0012,0057,0173,0302,0230,0007,0006,0243,
01392, RIO BRANCO ,0009,1082,0045,0077,0018,0061,0189,0338,0250,0006,0005,0261,
01392, RIO BRANCO ,0009,1082,0046,0070,0015,0056,0192,0333,0248,0006,0009,0263,
01392, RIO BRANCO ,0009,1082,0047,0086,0024,0068,0172,0337,0240,0006,0005,0251,
01392, RIO BRANCO ,0009,1503,0048,0054,0009,0039,0128,0231,0167,0002,0008,0177,
01392, RIO BRANCO ,0009,1503,0049,0056,0013,0064,0101,0228,0165,0004,0003,0172,
01392, RIO BRANCO ,0009,1171,0050,0048,0008,0056,0128,0233,0184,0001,0000,0185,
01392, RIO BRANCO ,0009,1090,0051,0078,0011,0066,0180,0331,0246,0002,0005,0253,
01392, RIO BRANCO ,0009,1090,0052,0083,0021,0048,0196,0334,0244,0002,0005,0251,
01392, RIO BRANCO ,0009,1090,0053,0098,0009,0054,0179,0333,0233,0000,0002,0235,
01392, RIO BRANCO ,0009,1775,0054,0066,0015,0080,0130,0281,0210,0003,0002,0215,
01392, RIO BRANCO ,0009,1112,0055,0088,0008,0068,0165,0333,0233,0002,0010,0245,
01392, RIO BRANCO ,0009,1112,0056,0073,0008,0066,0188,0335,0254,0002,0006,0262,
01392, RIO BRANCO ,0009,1104,0057,0065,0008,0073,0162,0308,0235,0002,0006,0243,
01392, RIO BRANCO ,0009,1104,0058,0084,0008,0056,0163,0308,0219,0001,0004,0224,
01392, RIO BRANCO ,0009,1783,0059,0059,0007,0069,0168,0302,0237,0003,0003,0243,
01392, RIO BRANCO ,0009,1520,0060,0090,0007,0073,0163,0333,0236,0004,0003,0243,
01392, RIO BRANCO ,0009,1520,0061,0071,0003,0077,0169,0331,0246,0005,0009,0260,
01392, RIO BRANCO ,0009,1520,0062,0083,0010,0055,0178,0324,0233,0002,0006,0241,
01392, RIO BRANCO ,0009,1538,0063,0063,0003,0077,0189,0336,0266,0002,0005,0273,
01392, RIO BRANCO ,0009,1139,0064,0075,0011,0072,0177,0338,0249,0005,0009,0263,
01392, RIO BRANCO ,0009,1139,0065,0058,0007,0083,0209,0357,0292,0001,0006,0299,
01392, RIO BRANCO ,0009,1139,0066,0076,0017,0075,0184,0341,0259,0004,0002,0265,
01392, RIO BRANCO ,0009,1333,0067,0075,0005,0068,0185,0335,0253,0002,0005,0260,
01392, RIO BRANCO ,0009,1147,0068,0062,0023,0070,0201,0340,0271,0005,0002,0278,
01392, RIO BRANCO ,0009,1147,0069,0055,0006,0065,0206,0335,0271,0004,0005,0280,
01392, RIO BRANCO ,0009,1554,0070,0066,0005,0044,0170,0287,0214,0006,0001,0221,
01392, RIO BRANCO ,0009,1155,0071,0044,0008,0056,0130,0241,0186,0007,0004,0197,
01392, RIO BRANCO ,0009,1155,0072,0048,0006,0054,0130,0238,0184,0005,0001,0190,
01392, RIO BRANCO ,0009,1155,0073,0046,0013,0056,0140,0251,0196,0002,0007,0205,
01392, RIO BRANCO ,0009,1562,0074,0053,0007,0089,0160,0306,0249,0002,0002,0253,
01392, RIO BRANCO ,0009,1562,0075,0037,0006,0075,0185,0302,0260,0003,0002,0265,
01392, RIO BRANCO ,0009,1163,0076,0069,0012,0071,0187,0337,0258,0004,0006,0268,
01392, RIO BRANCO ,0009,1163,0077,0057,0007,0072,0194,0339,0266,0003,0013,0282,
01392, RIO BRANCO ,0009,1570,0078,0069,0019,0060,0192,0334,0252,0006,0007,0265,
01392, RIO BRANCO ,0009,1287,0079,0075,0005,0077,0176,0344,0253,0006,0010,0269,
01392, RIO BRANCO ,0009,1287,0080,0082,0004,0069,0179,0339,0248,0003,0006,0257,
01392, RIO BRANCO ,0009,1171,0081,0048,0010,0065,0143,0264,0208,0001,0007,0216,
01392, RIO BRANCO ,0009,1171,0082,0052,0004,0064,0156,0277,0220,0003,0002,0225,
01392, RIO BRANCO ,0009,1171,0083,0043,0009,0053,0177,0282,0230,0002,0007,0239,
01392, RIO BRANCO ,0009,1171,0084,0040,0008,0055,0168,0269,0223,0002,0004,0229,
01392, RIO BRANCO ,0009,1180,0085,0076,0031,0076,0119,0277,0195,0001,0005,0201,
01392, RIO BRANCO ,0009,1198,0086,0079,0006,0062,0189,0338,0251,0003,0005,0259,
01392, RIO BRANCO ,0009,1201,0087,0082,0009,0059,0199,0344,0258,0002,0002,0262,
01392, RIO BRANCO ,0009,1201,0088,0092,0012,0047,0184,0327,0231,0000,0004,0235,
01392, RIO BRANCO ,0009,1589,0089,0081,0006,0057,0205,0354,0262,0005,0006,0273,
01392, RIO BRANCO ,0009,1210,0090,0063,0005,0085,0189,0348,0274,0005,0006,0285,
01392, RIO BRANCO ,0009,1210,0091,0059,0008,0070,0212,0351,0282,0006,0004,0292,
01392, RIO BRANCO ,0009,1228,0092,0062,0015,0073,0187,0329,0260,0004,0003,0267,
01392, RIO BRANCO ,0009,1236,0093,0075,0011,0059,0195,0337,0254,0002,0006,0262,
01392, RIO BRANCO ,0009,1236,0094,0069,0011,0058,0202,0340,0260,0003,0008,0271,
01392, RIO BRANCO ,0009,1236,0095,0077,0007,0057,0198,0340,0255,0006,0002,0263,
01392, RIO BRANCO ,0009,2356,0096,0059,0009,0054,0178,0301,0232,0002,0008,0242,
01392, RIO BRANCO ,0009,2356,0097,0050,0006,0063,0190,0305,0253,0001,0001,0255,
01392, RIO BRANCO ,0009,1244,0098,0056,0008,0049,0210,0322,0259,0004,0003,0266,
01392, RIO BRANCO ,0009,1252,0099,0101,0013,0054,0169,0334,0223,0002,0008,0233,
01392, RIO BRANCO ,0009,1252,0100,0071,0008,0064,0185,0328,0249,0004,0004,0257,
01392, RIO BRANCO ,0009,1597,0101,0067,0021,0067,0207,0346,0274,0002,0003,0279,
01392, RIO BRANCO ,0009,1619,0102,0057,0010,0079,0185,0326,0264,0003,0002,0269,
01392, RIO BRANCO ,0009,1260,0103,0068,0013,0077,0182,0336,0259,0004,0005,0268,
01392, RIO BRANCO ,0009,1627,0104,0055,0014,0062,0206,0334,0268,0000,0011,0279,
01392, RIO BRANCO ,0009,1627,0105,0072,0012,0069,0202,0354,0271,0007,0004,0282,
01392, RIO BRANCO ,0009,1635,0106,0066,0002,0074,0186,0332,0260,0001,0005,0266,
01392, RIO BRANCO ,0009,1635,0107,0080,0007,0067,0188,0341,0255,0002,0004,0261,
01392, RIO BRANCO ,0009,1635,0108,0071,0007,0066,0191,0336,0257,0006,0002,0265,
01392, RIO BRANCO ,0009,1295,0109,0095,0013,0067,0205,0374,0272,0003,0004,0279,
01392, RIO BRANCO ,0009,1295,0110,0075,0003,0063,0216,0367,0279,0005,0008,0292,
01392, RIO BRANCO ,0009,1309,0111,0063,0042,0055,0182,0304,0237,0001,0003,0241,
01392, RIO BRANCO ,0009,1317,0112,0090,0035,0056,0149,0304,0205,0004,0005,0214,
01392, RIO BRANCO ,0009,1325,0113,0090,0021,0062,0159,0318,0221,0002,0005,0228,
01392, RIO BRANCO ,0009,1015,0114,0095,0006,0063,0170,0336,0233,0004,0004,0241,
01392, RIO BRANCO ,0009,1015,0115,0089,0008,0065,0179,0335,0244,0000,0002,0246,
01392, RIO BRANCO ,0009,1015,0116,0065,0014,0070,0193,0335,0263,0003,0004,0270,
01392, RIO BRANCO ,0009,1015,0117,0070,0009,0072,0183,0338,0255,0004,0009,0268,
01392, RIO BRANCO ,0009,1228,0118,0064,0017,0068,0193,0331,0261,0004,0002,0267,
01392, RIO BRANCO ,0009,1260,0119,0064,0010,0076,0194,0340,0270,0004,0002,0276,
01392, RIO BRANCO ,0009,1023,0121,0057,0006,0054,0184,0302,0238,0002,0005,0245,
01392, RIO BRANCO ,0009,1589,0122,0083,0008,0050,0210,0351,0260,0003,0005,0268,
01392, RIO BRANCO ,0009,1600,0123,0069,0003,0062,0180,0324,0242,0004,0009,0255,
01392, RIO BRANCO ,0009,1619,0124,0077,0010,0064,0186,0332,0250,0003,0002,0255,
01392, RIO BRANCO ,0009,1040,0125,0074,0006,0073,0184,0340,0257,0006,0003,0266,
01392, RIO BRANCO ,0009,1538,0126,0077,0007,0061,0186,0331,0247,0002,0005,0254,
01392, RIO BRANCO ,0009,1244,0127,0078,0010,0056,0202,0343,0258,0003,0004,0265,
01392, RIO BRANCO ,0009,1295,0128,0060,0004,0070,0240,0375,0310,0002,0003,0315,
01392, RIO BRANCO ,0009,1198,0129,0075,0004,0080,0200,0366,0280,0006,0005,0291,
01392, RIO BRANCO ,0009,1260,0130,0047,0005,0066,0204,0327,0270,0005,0005,0280,
01392, RIO BRANCO ,0009,1317,0131,0105,0016,0049,0151,0307,0200,0001,0001,0202,
01392, RIO BRANCO ,0009,1538,0132,0067,0010,0063,0193,0336,0256,0009,0004,0269,
01392, RIO BRANCO ,0009,1040,0133,0064,0011,0070,0210,0348,0280,0004,0000,0284,
01392, RIO BRANCO ,0009,1333,0134,0067,0009,0060,0193,0329,0253,0004,0005,0262,
01392, RIO BRANCO ,0009,1333,0135,0070,0004,0055,0197,0336,0252,0006,0008,0266,
01392, RIO BRANCO ,0009,1333,0138,0073,0007,0071,0180,0336,0251,0002,0010,0263,
01392, RIO BRANCO ,0009,1635,0139,0064,0011,0057,0205,0336,0262,0003,0007,0272,
01392, RIO BRANCO ,0009,1627,0140,0089,0007,0058,0187,0344,0245,0004,0006,0255,
01392, RIO BRANCO ,0009,1619,0141,0076,0016,0050,0197,0329,0247,0003,0003,0253,
01392, RIO BRANCO ,0009,1600,0142,0076,0012,0065,0190,0340,0255,0005,0004,0264,
01392, RIO BRANCO ,0009,1597,0143,0066,0005,0059,0198,0331,0257,0002,0006,0265,
01392, RIO BRANCO ,0009,1589,0144,0073,0015,0054,0220,0355,0274,0003,0005,0282,
01392, RIO BRANCO ,0009,1538,0145,0067,0010,0069,0188,0331,0257,0004,0003,0264,
01392, RIO BRANCO ,0009,1520,0146,0063,0008,0079,0178,0328,0257,0003,0005,0265,
01392, RIO BRANCO ,0009,1406,0147,0052,0006,0067,0151,0278,0218,0004,0004,0226,
01392, RIO BRANCO ,0009,1449,0148,0062,0006,0056,0220,0344,0276,0004,0002,0282,
01392, RIO BRANCO ,0009,1430,0149,0079,0009,0059,0187,0340,0246,0007,0008,0261,
01392, RIO BRANCO ,0009,1422,0150,0059,0006,0067,0233,0370,0300,0005,0006,0311,
01392, RIO BRANCO ,0009,1384,0151,0049,0017,0054,0229,0338,0283,0000,0006,0289,
01392, RIO BRANCO ,0009,1376,0152,0066,0003,0071,0182,0332,0253,0007,0006,0266,
01392, RIO BRANCO ,0009,1350,0153,0051,0007,0067,0123,0250,0190,0005,0004,0199,
01392, RIO BRANCO ,0009,1570,0154,0074,0004,0063,0188,0335,0251,0003,0007,0261,
01392, RIO BRANCO ,0009,1554,0155,0065,0004,0051,0149,0273,0200,0002,0006,0208,
01392, RIO BRANCO ,0009,1368,0157,0081,0011,0071,0183,0342,0254,0004,0003,0261,
01392, RIO BRANCO ,0009,1104,0158,0062,0004,0059,0173,0301,0232,0004,0003,0239,
01392, RIO BRANCO ,0009,1104,0159,0067,0012,0065,0166,0313,0231,0004,0011,0246,
01392, RIO BRANCO ,0009,1767,0160,0085,0009,0065,0186,0340,0251,0004,0000,0255,
01392, RIO BRANCO ,0009,1252,0161,0092,0005,0058,0178,0336,0236,0002,0006,0244,
01392, RIO BRANCO ,0009,1643,0162,0073,0008,0052,0120,0253,0172,0002,0006,0180,
01392, RIO BRANCO ,0009,1350,0164,0052,0009,0070,0126,0251,0196,0002,0001,0199,
01392, RIO BRANCO ,0009,1201,0165,0089,0011,0045,0183,0326,0228,0002,0007,0237,
01392, RIO BRANCO ,0009,1180,0166,0087,0024,0059,0120,0268,0179,0000,0002,0181,
01392, RIO BRANCO ,0009,1163,0167,0068,0008,0059,0202,0339,0261,0007,0003,0271,
01392, RIO BRANCO ,0009,1112,0168,0095,0011,0056,0168,0329,0224,0003,0007,0234,
01392, RIO BRANCO ,0009,1031,0169,0068,0006,0076,0180,0334,0256,0005,0005,0266,
01392, RIO BRANCO ,0009,2038,0170,0063,0006,0055,0087,0210,0142,0005,0000,0147,
01392, RIO BRANCO ,0009,1236,0171,0074,0008,0055,0198,0334,0253,0005,0002,0260,
01392, RIO BRANCO ,0009,1066,0172,0077,0014,0071,0206,0363,0277,0005,0004,0286,
01392, RIO BRANCO ,0009,1724,0173,0077,0008,0048,0185,0320,0233,0004,0006,0243,
01392, RIO BRANCO ,0009,1732,0174,0057,0008,0053,0177,0294,0230,0002,0005,0237,
01392, RIO BRANCO ,0009,1147,0175,0059,0007,0082,0192,0337,0274,0001,0003,0278,
01392, RIO BRANCO ,0009,1198,0176,0073,0007,0084,0166,0329,0250,0004,0002,0256,
01392, RIO BRANCO ,0009,1139,0177,0058,0009,0066,0206,0340,0272,0007,0003,0282,
01392, RIO BRANCO ,0009,1775,0178,0051,0007,0045,0120,0223,0165,0002,0005,0172,
01392, RIO BRANCO ,0009,1015,0179,0098,0005,0063,0169,0337,0232,0001,0006,0239,
01392, RIO BRANCO ,0009,1260,0180,0063,0007,0072,0194,0339,0266,0005,0005,0276,
01392, RIO BRANCO ,0009,1767,0181,0065,0012,0074,0177,0330,0251,0004,0010,0265,
01392, RIO BRANCO ,0009,1317,0182,0126,0040,0048,0126,0301,0174,0001,0000,0175,
01392, RIO BRANCO ,0009,1589,0183,0084,0008,0066,0200,0355,0266,0003,0002,0271,
01392, RIO BRANCO ,0009,1724,0184,0085,0013,0047,0191,0327,0238,0001,0003,0242,
01392, RIO BRANCO ,0009,1600,0185,0076,0004,0059,0186,0325,0245,0001,0003,0249,
01392, RIO BRANCO ,0009,1228,0187,0079,0008,0065,0174,0327,0239,0004,0005,0248,
01392, RIO BRANCO ,0009,1040,0188,0068,0008,0048,0199,0326,0247,0006,0005,0258,
01392, RIO BRANCO ,0009,1082,0189,0075,0005,0086,0165,0337,0251,0004,0007,0262,
01392, RIO BRANCO ,0009,1147,0190,0067,0007,0060,0193,0328,0253,0002,0006,0261,
01392, RIO BRANCO ,0009,1180,0191,0074,0024,0057,0135,0277,0192,0003,0008,0203,
01392, RIO BRANCO ,0009,1163,0193,0066,0006,0073,0181,0335,0254,0003,0012,0269,
01392, RIO BRANCO ,0009,1732,0194,0064,0007,0053,0159,0285,0212,0002,0007,0221,
01392, RIO BRANCO ,0009,1570,0195,0068,0011,0068,0188,0330,0256,0003,0003,0262,
01392, RIO BRANCO ,0009,1619,0196,0090,0011,0054,0180,0328,0234,0002,0002,0238,
01392, RIO BRANCO ,0009,1597,0197,0063,0014,0059,0214,0343,0273,0001,0006,0280,
01392, RIO BRANCO ,0009,1660,0198,0090,0002,0060,0176,0331,0236,0003,0002,0241,
01392, RIO BRANCO ,0009,1384,0199,0076,0004,0039,0211,0334,0250,0002,0006,0258,
01392, RIO BRANCO ,0009,1767,0203,0081,0008,0065,0187,0338,0252,0002,0003,0257,
01392, RIO BRANCO ,0009,1678,0204,0073,0014,0082,0166,0336,0248,0009,0006,0263,
01392, RIO BRANCO ,0009,1139,0205,0071,0008,0052,0199,0332,0251,0004,0006,0261,
01392, RIO BRANCO ,0009,1236,0206,0074,0011,0064,0189,0333,0253,0004,0002,0259,
01392, RIO BRANCO ,0009,1422,0207,0079,0008,0093,0193,0375,0286,0005,0005,0296,
01392, RIO BRANCO ,0009,1724,0209,0085,0006,0051,0180,0330,0231,0004,0010,0245,
01392, RIO BRANCO ,0009,1058,0210,0067,0017,0059,0197,0334,0256,0003,0008,0267,
01392, RIO BRANCO ,0009,1066,0211,0068,0003,0059,0199,0335,0258,0004,0005,0267,
01392, RIO BRANCO ,0009,1686,0213,0147,0017,0036,0140,0328,0176,0002,0003,0181,
01392, RIO BRANCO ,0009,1244,0214,0079,0016,0051,0201,0338,0252,0003,0004,0259,
01392, RIO BRANCO ,0009,1406,0215,0063,0003,0066,0139,0277,0205,0005,0004,0214,
01392, RIO BRANCO ,0009,1740,0216,0069,0011,0068,0196,0337,0264,0001,0003,0268,
01392, RIO BRANCO ,0009,1694,0217,0072,0008,0075,0179,0330,0254,0000,0004,0258,
01392, RIO BRANCO ,0009,1708,0218,0083,0005,0054,0222,0369,0276,0003,0007,0286,
01392, RIO BRANCO ,0009,1767,0219,0056,0008,0091,0185,0337,0276,0002,0003,0281,
01392, RIO BRANCO ,0009,1759,0220,0070,0005,0077,0164,0320,0241,0004,0005,0250,
01392, RIO BRANCO ,0009,1724,0221,0077,0006,0051,0197,0329,0248,0002,0002,0252,
01392, RIO BRANCO ,0009,1732,0222,0068,0006,0054,0166,0293,0220,0003,0002,0225,
01392, RIO BRANCO ,0009,1716,0223,0064,0007,0051,0178,0298,0229,0002,0003,0234,
01392, RIO BRANCO ,0009,1198,0224,0067,0016,0091,0152,0326,0243,0005,0011,0259,
01392, RIO BRANCO ,0009,1503,0225,0076,0004,0046,0096,0224,0142,0003,0003,0148,
01392, RIO BRANCO ,0009,1678,0226,0078,0012,0077,0175,0336,0252,0003,0003,0258,
01392, RIO BRANCO ,0009,1791,0228,0064,0011,0070,0154,0296,0224,0004,0004,0232,
01392, RIO BRANCO ,0009,1252,0229,0077,0008,0068,0182,0335,0250,0003,0005,0258,
01392, RIO BRANCO ,0009,1805,0230,0100,0008,0083,0095,0280,0178,0000,0002,0180,
01392, RIO BRANCO ,0009,1147,0231,0107,0012,0064,0155,0331,0219,0001,0004,0224,
01392, RIO BRANCO ,0009,1767,0232,0082,0012,0072,0183,0343,0255,0000,0006,0261,
01392, RIO BRANCO ,0009,1090,0233,0103,0004,0068,0161,0336,0229,0002,0002,0233,
01392, RIO BRANCO ,0009,1201,0235,0096,0009,0039,0185,0322,0224,0001,0001,0226,
01392, RIO BRANCO ,0009,1155,0236,0055,0017,0047,0072,0179,0119,0004,0001,0124,
01392, RIO BRANCO ,0009,1708,0238,0081,0015,0072,0191,0355,0263,0002,0009,0274,
01392, RIO BRANCO ,0009,1856,0239,0084,0003,0048,0195,0332,0243,0002,0003,0248,
01392, RIO BRANCO ,0009,1830,0240,0050,0000,0043,0114,0214,0157,0006,0001,0164,
01392, RIO BRANCO ,0009,1627,0241,0084,0007,0080,0167,0340,0247,0001,0008,0256,
01392, RIO BRANCO ,0009,1848,0243,0057,0018,0019,0075,0154,0094,0002,0001,0097,
01392, RIO BRANCO ,0009,1333,0244,0086,0007,0059,0175,0334,0234,0003,0011,0248,
01392, RIO BRANCO ,0009,1104,0245,0077,0004,0068,0160,0311,0228,0002,0004,0234,
01392, RIO BRANCO ,0009,1333,0246,0076,0010,0070,0180,0334,0250,0004,0004,0258,
01392, RIO BRANCO ,0009,1104,0247,0075,0008,0055,0173,0310,0228,0001,0006,0235,
01392, RIO BRANCO ,0009,1864,0248,0085,0003,0077,0164,0337,0241,0003,0008,0252,
01392, RIO BRANCO ,0009,1309,0249,0073,0042,0066,0163,0307,0229,0000,0005,0234,
01392, RIO BRANCO ,0009,1104,0250,0072,0008,0055,0175,0310,0230,0005,0003,0238,
01392, RIO BRANCO ,0009,1201,0251,0108,0010,0053,0160,0325,0213,0002,0002,0217,
01392, RIO BRANCO ,0009,1678,0253,0077,0017,0078,0171,0333,0249,0002,0005,0256,
01392, RIO BRANCO ,0009,1660,0254,0077,0015,0066,0191,0339,0257,0003,0002,0262,
01392, RIO BRANCO ,0009,1708,0255,0072,0008,0073,0207,0362,0280,0004,0006,0290,
01392, RIO BRANCO ,0009,1252,0256,0099,0014,0076,0154,0333,0230,0003,0001,0234,
01392, RIO BRANCO ,0009,1872,0257,0072,0005,0077,0155,0311,0232,0002,0005,0239,
01392, RIO BRANCO ,0009,1201,0258,0103,0006,0061,0161,0332,0222,0002,0005,0229,
01392, RIO BRANCO ,0009,1180,0259,0101,0020,0051,0118,0275,0169,0002,0003,0174,
01392, RIO BRANCO ,0009,1732,0260,0085,0006,0059,0147,0296,0206,0004,0001,0211,
01392, RIO BRANCO ,0009,1937,0261,0084,0008,0050,0161,0298,0211,0001,0002,0214,
01392, RIO BRANCO ,0009,1902,0262,0088,0037,0059,0182,0332,0241,0001,0002,0244,
01392, RIO BRANCO ,0009,1953,0263,0082,0012,0056,0196,0339,0252,0001,0004,0257,
01392, RIO BRANCO ,0009,1899,0264,0088,0008,0094,0182,0374,0276,0006,0004,0286,
01392, RIO BRANCO ,0009,1910,0265,0096,0014,0070,0188,0360,0258,0005,0001,0264,
01392, RIO BRANCO ,0009,1961,0266,0064,0004,0062,0187,0323,0249,0004,0006,0259,
01392, RIO BRANCO ,0009,1996,0267,0035,0007,0048,0108,0198,0156,0003,0004,0163,
01392, RIO BRANCO ,0009,1929,0268,0089,0011,0036,0153,0285,0189,0004,0003,0196,
01392, RIO BRANCO ,0009,1740,0269,0073,0008,0065,0192,0337,0257,0003,0004,0264,
01392, RIO BRANCO ,0009,1880,0270,0083,0008,0066,0182,0338,0248,0004,0003,0255,
01392, RIO BRANCO ,0009,1988,0271,0062,0007,0019,0093,0178,0112,0004,0000,0116,
01392, RIO BRANCO ,0009,1325,0272,0102,0008,0068,0141,0317,0209,0002,0004,0215,
01392, RIO BRANCO ,0009,1643,0273,0065,0007,0053,0103,0227,0156,0001,0005,0162,
01392, RIO BRANCO ,0009,1708,0274,0091,0006,0054,0201,0355,0255,0003,0006,0264,
01392, RIO BRANCO ,0009,1970,0275,0029,0007,0018,0047,0097,0065,0000,0003,0068,
01392, RIO BRANCO ,0009,1660,0276,0103,0007,0057,0171,0332,0228,0000,0001,0229,
01392, RIO BRANCO ,0009,1740,0277,0096,0005,0062,0172,0332,0234,0002,0000,0236,
01392, RIO BRANCO ,0009,1694,0278,0107,0011,0044,0169,0326,0213,0003,0003,0219,
01392, RIO BRANCO ,0009,2003,0279,0089,0034,0043,0152,0289,0195,0002,0003,0200,
01392, RIO BRANCO ,0009,1899,0280,0106,0005,0066,0149,0327,0215,0004,0002,0221,
01392, RIO BRANCO ,0009,1953,0281,0107,0011,0057,0165,0336,0222,0003,0004,0229,
01392, RIO BRANCO ,0009,1031,0282,0097,0006,0060,0174,0337,0234,0003,0003,0240,
01392, RIO BRANCO ,0009,1678,0283,0105,0010,0065,0159,0335,0224,0004,0002,0230,
01392, RIO BRANCO ,0009,1740,0284,0093,0007,0055,0176,0330,0231,0005,0001,0237,
01392, RIO BRANCO ,0009,1430,0285,0100,0009,0069,0147,0330,0216,0008,0006,0230,
01392, RIO BRANCO ,0009,1198,0286,0113,0005,0091,0152,0363,0243,0005,0002,0250,
01392, RIO BRANCO ,0009,1937,0287,0098,0002,0045,0151,0301,0196,0002,0005,0203,
01392, RIO BRANCO ,0009,1929,0288,0083,0009,0046,0147,0284,0193,0002,0006,0201,
01392, RIO BRANCO ,0009,1724,0289,0101,0002,0054,0171,0331,0225,0002,0003,0230,
01392, RIO BRANCO ,0009,1627,0290,0106,0006,0050,0165,0334,0215,0007,0006,0228,
01392, RIO BRANCO ,0009,1422,0291,0101,0008,0072,0164,0355,0236,0008,0010,0254,
01392, RIO BRANCO ,0009,1899,0292,0108,0008,0076,0184,0375,0260,0007,0000,0267,
01392, RIO BRANCO ,0009,1554,0293,0068,0006,0060,0128,0265,0188,0002,0007,0197,
01392, RIO BRANCO ,0009,1520,0294,0102,0008,0073,0145,0329,0218,0002,0007,0227,
01392, RIO BRANCO ,0009,1058,0295,0084,0006,0072,0168,0335,0240,0003,0008,0251,
01392, RIO BRANCO ,0009,1872,0296,0083,0012,0071,0150,0314,0221,0005,0005,0231,
01392, RIO BRANCO ,0009,2054,0297,0104,0011,0042,0143,0296,0185,0004,0003,0192,
01392, RIO BRANCO ,0009,2046,0298,0087,0005,0063,0163,0322,0226,0006,0003,0235,
01392, RIO BRANCO ,0009,2020,0299,0093,0012,0064,0163,0330,0227,0002,0008,0237,
01392, RIO BRANCO ,0009,2038,0300,0076,0022,0082,0178,0342,0260,0003,0003,0266,
01392, RIO BRANCO ,0009,2011,0301,0028,0006,0029,0074,0135,0103,0001,0003,0107,
01392, RIO BRANCO ,0009,1333,0302,0097,0009,0067,0154,0325,0221,0004,0003,0228,
01392, RIO BRANCO ,0009,1023,0303,0079,0009,0055,0153,0293,0208,0003,0003,0214,
01392, RIO BRANCO ,0009,1759,0306,0087,0006,0069,0153,0323,0222,0010,0004,0236,
01392, RIO BRANCO ,0009,1961,0307,0076,0008,0069,0165,0318,0234,0006,0002,0242,
01392, RIO BRANCO ,0009,1899,0308,0112,0007,0092,0165,0376,0257,0003,0004,0264,
01392, RIO BRANCO ,0009,1791,0309,0077,0003,0011,0079,0168,0090,0001,0000,0091,
01392, RIO BRANCO ,0009,1880,0311,0100,0009,0067,0167,0339,0234,0003,0002,0239,
01392, RIO BRANCO ,0009,2046,0312,0100,0012,0051,0166,0327,0217,0003,0007,0227,
01392, RIO BRANCO ,0009,1198,0313,0101,0004,0086,0157,0360,0243,0008,0008,0259,
01392, RIO BRANCO ,0009,1953,0314,0087,0008,0058,0184,0338,0242,0006,0003,0251,
01392, RIO BRANCO ,0009,1112,0315,0096,0006,0048,0186,0338,0234,0005,0003,0242,
01392, RIO BRANCO ,0009,1937,0316,0108,0011,0045,0146,0306,0191,0002,0005,0198,
01392, RIO BRANCO ,0009,1716,0317,0070,0010,0070,0152,0300,0222,0003,0005,0230,
01392, RIO BRANCO ,0009,1023,0318,0089,0009,0054,0158,0307,0212,0002,0004,0218,
01392, RIO BRANCO ,0009,2062,0319,0054,0006,0074,0164,0301,0238,0001,0008,0247,
01392, RIO BRANCO ,0009,2062,0320,0067,0003,0075,0151,0297,0226,0002,0002,0230,
01392, RIO BRANCO ,0009,2070,0321,0075,0010,0075,0156,0324,0231,0006,0012,0249,
01392, RIO BRANCO ,0009,2070,0322,0090,0012,0089,0142,0331,0231,0006,0004,0241,
01392, RIO BRANCO ,0009,2070,0323,0056,0006,0072,0189,0325,0261,0005,0003,0269,
01392, RIO BRANCO ,0009,2089,0324,0057,0010,0073,0183,0324,0256,0005,0006,0267,
01392, RIO BRANCO ,0009,2089,0325,0064,0011,0053,0201,0329,0254,0006,0005,0265,
01392, RIO BRANCO ,0009,2089,0326,0075,0012,0067,0177,0325,0244,0002,0004,0250,
01392, RIO BRANCO ,0009,2089,0327,0078,0010,0065,0177,0328,0242,0002,0006,0250,
01392, RIO BRANCO ,0009,2097,0328,0081,0009,0074,0176,0332,0250,0000,0001,0251,
01392, RIO BRANCO ,0009,2097,0329,0075,0009,0075,0179,0336,0254,0001,0006,0261,
01392, RIO BRANCO ,0009,2097,0330,0099,0003,0078,0157,0339,0235,0004,0001,0240,
01392, RIO BRANCO ,0009,2100,0331,0062,0007,0083,0173,0330,0256,0006,0006,0268,
01392, RIO BRANCO ,0009,2100,0332,0067,0010,0086,0155,0319,0241,0008,0003,0252,
01392, RIO BRANCO ,0009,2100,0333,0086,0010,0075,0150,0322,0225,0004,0007,0236,
01392, RIO BRANCO ,0009,2100,0334,0091,0003,0056,0163,0316,0219,0004,0002,0225,
01392, RIO BRANCO ,0009,2119,0335,0061,0013,0076,0184,0333,0260,0007,0005,0272,
01392, RIO BRANCO ,0009,2119,0336,0068,0009,0083,0169,0338,0252,0009,0009,0270,
01392, RIO BRANCO ,0009,2127,0337,0083,0009,0060,0185,0334,0245,0001,0005,0251,
01392, RIO BRANCO ,0009,2127,0338,0087,0007,0066,0176,0337,0242,0003,0005,0250,
01392, RIO BRANCO ,0009,2127,0339,0097,0012,0072,0156,0329,0228,0002,0002,0232,
01392, RIO BRANCO ,0009,2127,0340,0111,0006,0049,0155,0324,0204,0006,0003,0213,
01392, RIO BRANCO ,0009,2135,0341,0075,0006,0068,0190,0338,0258,0002,0003,0263,
01392, RIO BRANCO ,0009,2135,0342,0057,0004,0053,0211,0332,0264,0005,0006,0275,
01392, RIO BRANCO ,0009,2135,0343,0062,0019,0061,0207,0337,0268,0002,0005,0275,
01392, RIO BRANCO ,0009,2135,0344,0074,0012,0060,0195,0337,0255,0005,0003,0263,
01392, RIO BRANCO ,0009,2143,0345,0092,0002,0060,0184,0344,0244,0004,0004,0252,
01392, RIO BRANCO ,0009,2151,0346,0065,0013,0063,0193,0328,0256,0003,0004,0263,
01392, RIO BRANCO ,0009,2160,0347,0061,0013,0048,0206,0324,0254,0004,0005,0263,
01392, RIO BRANCO ,0009,2160,0348,0079,0006,0079,0161,0322,0240,0001,0002,0243,
01392, RIO BRANCO ,0009,2364,0349,0075,0006,0051,0193,0328,0244,0007,0002,0253,
01392, RIO BRANCO ,0009,2364,0350,0073,0009,0050,0200,0327,0250,0004,0000,0254,
01392, RIO BRANCO ,0009,2178,0351,0092,0012,0056,0177,0329,0233,0003,0001,0237,
01392, RIO BRANCO ,0009,2178,0352,0083,0000,0077,0171,0336,0248,0003,0002,0253,
01392, RIO BRANCO ,0009,2186,0353,0068,0007,0070,0180,0324,0250,0003,0003,0256,
01392, RIO BRANCO ,0009,2186,0354,0061,0003,0068,0187,0323,0255,0004,0003,0262,
01392, RIO BRANCO ,0009,2186,0355,0072,0012,0073,0166,0318,0239,0006,0001,0246,
01392, RIO BRANCO ,0009,2186,0356,0075,0009,0065,0180,0326,0245,0004,0002,0251,
01392, RIO BRANCO ,0009,2186,0357,0070,0005,0060,0191,0326,0251,0001,0004,0256,
01392, RIO BRANCO ,0009,2194,0358,0103,0021,0058,0156,0323,0214,0002,0004,0220,
01392, RIO BRANCO ,0009,2208,0359,0090,0012,0054,0151,0301,0205,0002,0004,0211,
01392, RIO BRANCO ,0009,2160,0360,0074,0004,0053,0163,0295,0216,0003,0002,0221,
01392, RIO BRANCO ,0009,2208,0361,0076,0006,0058,0168,0303,0226,0000,0001,0227,
01392, RIO BRANCO ,0009,2208,0362,0084,0002,0041,0164,0296,0205,0003,0004,0212,
01392, RIO BRANCO ,0009,2216,0363,0073,0008,0074,0182,0332,0256,0000,0003,0259,
01392, RIO BRANCO ,0009,2216,0364,0077,0012,0064,0177,0325,0241,0004,0003,0248,
01392, RIO BRANCO ,0009,2216,0365,0070,0006,0070,0184,0333,0254,0001,0008,0263,
01392, RIO BRANCO ,0009,2216,0366,0086,0006,0063,0170,0329,0233,0008,0002,0243,
01392, RIO BRANCO ,0009,2224,0367,0075,0007,0066,0184,0334,0250,0004,0005,0259,
01392, RIO BRANCO ,0009,2224,0368,0068,0009,0072,0189,0335,0261,0002,0004,0267,
01392, RIO BRANCO ,0009,2224,0369,0089,0002,0062,0176,0336,0238,0005,0004,0247,
01392, RIO BRANCO ,0009,2224,0370,0077,0011,0079,0174,0334,0253,0001,0003,0257,
01392, RIO BRANCO ,0009,2232,0371,0070,0005,0077,0156,0311,0233,0002,0006,0241,
01392, RIO BRANCO ,0009,2232,0372,0070,0007,0090,0141,0311,0231,0004,0006,0241,
01392, RIO BRANCO ,0009,2240,0373,0075,0004,0051,0197,0330,0248,0006,0001,0255,
01392, RIO BRANCO ,0009,2240,0374,0079,0009,0062,0198,0344,0260,0003,0002,0265,
01392, RIO BRANCO ,0009,2259,0375,0066,0009,0069,0163,0306,0232,0003,0005,0240,
01392, RIO BRANCO ,0009,2259,0376,0049,0006,0082,0169,0310,0251,0007,0003,0261,
01392, RIO BRANCO ,0009,2259,0377,0055,0009,0071,0167,0305,0238,0004,0008,0250,
01392, RIO BRANCO ,0009,2267,0378,0075,0012,0077,0178,0343,0255,0005,0008,0268,
01392, RIO BRANCO ,0009,2275,0379,0086,0016,0072,0169,0331,0241,0002,0002,0245,
01392, RIO BRANCO ,0009,2275,0380,0086,0010,0074,0163,0325,0237,0001,0001,0239,
01392, RIO BRANCO ,0009,2275,0381,0082,0004,0052,0188,0331,0240,0004,0005,0249,
01392, RIO BRANCO ,0009,2275,0382,0104,0003,0058,0171,0335,0229,0000,0002,0231,
01392, RIO BRANCO ,0009,2283,0383,0099,0007,0076,0157,0340,0233,0002,0006,0241,
01392, RIO BRANCO ,0009,2283,0384,0091,0008,0077,0159,0339,0236,0003,0009,0248,
01392, RIO BRANCO ,0009,2097,0385,0098,0007,0061,0171,0333,0232,0001,0002,0235,
01392, RIO BRANCO ,0009,2305,0386,0061,0004,0064,0205,0337,0269,0005,0002,0276,
01392, RIO BRANCO ,0009,2305,0387,0065,0010,0059,0197,0332,0256,0006,0005,0267,
01392, RIO BRANCO ,0009,2305,0388,0077,0004,0056,0193,0335,0249,0004,0005,0258,
01392, RIO BRANCO ,0009,2305,0389,0077,0007,0052,0202,0333,0254,0002,0000,0256,
01392, RIO BRANCO ,0009,2313,0390,0061,0016,0096,0169,0337,0265,0005,0006,0276,
01392, RIO BRANCO ,0009,2313,0391,0064,0011,0083,0179,0341,0262,0013,0002,0277,
01392, RIO BRANCO ,0009,2313,0392,0057,0011,0074,0203,0341,0277,0002,0005,0284,
01392, RIO BRANCO ,0009,2313,0393,0073,0009,0081,0177,0339,0258,0004,0004,0266,
01392, RIO BRANCO ,0009,2321,0394,0082,0006,0067,0176,0333,0243,0005,0003,0251,
01392, RIO BRANCO ,0009,2321,0395,0087,0012,0058,0188,0343,0246,0001,0009,0256,
01392, RIO BRANCO ,0009,2330,0396,0084,0009,0058,0189,0334,0247,0003,0000,0250,
01392, RIO BRANCO ,0009,2330,0397,0084,0010,0062,0189,0339,0251,0003,0001,0255,
01392, RIO BRANCO ,0009,2330,0398,0071,0007,0056,0202,0335,0258,0001,0005,0264,
01392, RIO BRANCO ,0009,2330,0399,0056,0009,0067,0200,0333,0267,0004,0006,0277,
01392, RIO BRANCO ,0009,2330,0400,0084,0005,0054,0181,0325,0235,0002,0004,0241,
01392, RIO BRANCO ,0009,2330,0401,0085,0007,0055,0190,0335,0245,0004,0001,0250,
01392, RIO BRANCO ,0009,2330,0402,0083,0015,0069,0185,0342,0254,0003,0002,0259,
01392, RIO BRANCO ,0009,1899,0403,0114,0010,0085,0164,0372,0249,0007,0002,0258,
01392, RIO BRANCO ,0009,2020,0404,0080,0009,0064,0172,0328,0236,0009,0003,0248,
01392, RIO BRANCO ,0009,1899,0405,0105,0015,0074,0189,0374,0263,0001,0005,0269,
01392, RIO BRANCO ,0009,1902,0406,0094,0029,0066,0167,0338,0233,0005,0006,0244,
01392, RIO BRANCO ,0009,2046,0407,0101,0001,0059,0174,0339,0233,0001,0004,0238,
01392, RIO BRANCO ,0009,1031,0408,0089,0012,0076,0162,0334,0238,0003,0004,0245,
01392, RIO BRANCO ,0009,1198,0409,0099,0004,0118,0140,0361,0258,0001,0003,0262,
01392, RIO BRANCO ,0009,2020,0410,0071,0010,0078,0172,0331,0250,0006,0004,0260,
01392, RIO BRANCO ,0009,2097,0414,0139,0001,0049,0152,0346,0201,0003,0003,0207,
01392, RIO BRANCO ,0009,1899,0415,0127,0013,0074,0159,0368,0233,0002,0006,0241,
01392, RIO BRANCO ,0009,2003,0416,0067,0014,0026,0092,0187,0118,0001,0001,0120,
01392, RIO BRANCO ,0009,1929,0417,0043,0006,0045,0121,0209,0166,0000,0000,0166,
01392, RIO BRANCO ,0009,2100,0418,0102,0004,0075,0136,0324,0211,0008,0003,0222,
01392, RIO BRANCO ,0009,1880,0420,0101,0014,0072,0153,0333,0225,0003,0004,0232,
01392, RIO BRANCO ,0009,1937,0421,0105,0009,0045,0156,0310,0201,0002,0002,0205,
01392, RIO BRANCO ,0009,1023,0422,0063,0004,0052,0127,0246,0179,0001,0003,0183,
01392, RIO BRANCO ,0009,2062,0423,0024,0004,0036,0046,0109,0082,0001,0002,0085,
01392, RIO BRANCO ,0009,2208,0424,0084,0014,0062,0120,0274,0182,0006,0002,0190,
01392, RIO BRANCO ,0009,2364,0425,0071,0009,0083,0166,0328,0249,0005,0003,0257,
01392, RIO BRANCO ,0009,1600,0427,0097,0016,0079,0153,0337,0232,0001,0007,0240,
01392, RIO BRANCO ,0009,2356,0428,0020,0000,0022,0048,0096,0070,0003,0003,0076,
01392, RIO BRANCO ,0009,2160,0429,0078,0006,0064,0130,0283,0194,0008,0003,0205,
01392, RIO BRANCO ,0009,1872,0430,0081,0006,0080,0144,0312,0224,0006,0001,0231,
01392, RIO BRANCO ,0009,2054,0431,0080,0007,0057,0164,0305,0221,0002,0002,0225,
01392, RIO BRANCO ,0009,2046,0432,0113,0017,0062,0156,0340,0218,0004,0005,0227,
01392, RIO BRANCO ,0009,2020,0433,0076,0002,0081,0157,0330,0238,0011,0005,0254,
01392, RIO BRANCO ,0009,1198,0434,0088,0007,0097,0135,0330,0232,0006,0004,0242,
01392, RIO BRANCO ,0009,2380,0435,0091,0007,0071,0161,0331,0232,0005,0003,0240,
01392, RIO BRANCO ,0009,1899,0438,0096,0010,0081,0185,0371,0266,0005,0004,0275,
01392, RIO BRANCO ,0009,1961,0443,0047,0007,0107,0164,0324,0271,0006,0000,0277,
01392, RIO BRANCO ,0009,1694,0444,0020,0000,0025,0044,0089,0069,0000,0000,0069,
01392, RIO BRANCO ,0009,2380,0445,0077,0007,0082,0173,0338,0255,0003,0003,0261,
01392, RIO BRANCO ,0009,1899,0446,0068,0003,0122,0176,0374,0298,0004,0004,0306,
01392, RIO BRANCO ,0009,1244,0447,0027,0002,0055,0083,0171,0138,0004,0002,0144,
01392, RIO BRANCO ,0009,1198,0448,0048,0004,0137,0135,0332,0272,0005,0007,0284,
01392, RIO BRANCO ,0009,1708,0449,0069,0005,0099,0177,0351,0276,0005,0001,0282,
01392, RIO BRANCO ,0009,2186,0450,0049,0005,0060,0119,0232,0179,0001,0003,0183,
01392, RIO BRANCO ,0009,1066,0451,0023,0002,0030,0080,0136,0110,0002,0001,0113,
01392, RIO BRANCO ,0009,2070,0452,0035,0001,0041,0069,0151,0110,0003,0003,0116,
01392, RIO BRANCO ,0009,1252,0453,0077,0003,0078,0186,0344,0264,0002,0001,0267,
01392, RIO BRANCO ,0009,1139,0454,0012,0001,0033,0062,0109,0095,0001,0001,0097,
01392, RIO BRANCO ,0009,2100,0455,0016,0001,0055,0089,0162,0144,0002,0000,0146,
01392, RIO BRANCO ,0009,2380,0456,0049,0005,0073,0156,0280,0229,0001,0001,0231,
01392, RIO BRANCO ,0009,2194,0457,0014,0002,0017,0033,0066,0050,0002,0000,0052,
01392, RIO BRANCO ,0009,1520,0458,0023,0002,0051,0083,0160,0134,0002,0001,0137,
01392, RIO BRANCO ,0009,1260,0459,0017,0000,0029,0049,0101,0078,0004,0002,0084,
01392, RIO BRANCO ,0009,1600,0462,0013,0000,0022,0036,0073,0058,0002,0000,0060,
01392, RIO BRANCO ,0009,2127,0463,0019,0000,0017,0035,0072,0052,0000,0001,0053,
01457, SENA MADUREIRA ,0003,1015,0001,0137,0033,0052,0101,0297,0153,0006,0001,0160,
01457, SENA MADUREIRA ,0003,1023,0002,0101,0019,0043,0129,0277,0172,0001,0003,0176,
01457, SENA MADUREIRA ,0003,1023,0003,0100,0016,0049,0116,0266,0165,0001,0000,0166,
01457, SENA MADUREIRA ,0003,1023,0004,0131,0008,0033,0116,0284,0149,0001,0003,0153,
01457, SENA MADUREIRA ,0003,1031,0005,0111,0031,0049,0163,0328,0212,0002,0003,0217,
01457, SENA MADUREIRA ,0003,1031,0006,0117,0018,0066,0144,0330,0210,0000,0003,0213,
01457, SENA MADUREIRA ,0003,1040,0007,0101,0016,0055,0135,0293,0190,0001,0001,0192,
01457, SENA MADUREIRA ,0003,1040,0008,0124,0015,0047,0122,0298,0169,0003,0002,0174,
01457, SENA MADUREIRA ,0003,1058,0009,0101,0021,0058,0113,0274,0171,0001,0001,0173,
01457, SENA MADUREIRA ,0003,1066,0010,0116,0009,0038,0166,0326,0204,0002,0004,0210,
01457, SENA MADUREIRA ,0003,1066,0011,0130,0008,0052,0154,0338,0206,0000,0002,0208,
01457, SENA MADUREIRA ,0003,1066,0012,0133,0011,0055,0145,0337,0200,0003,0001,0204,
01457, SENA MADUREIRA ,0003,1074,0013,0091,0008,0046,0135,0278,0181,0003,0003,0187,
01457, SENA MADUREIRA ,0003,1082,0014,0107,0018,0035,0125,0272,0160,0002,0003,0165,
01457, SENA MADUREIRA ,0003,1082,0015,0107,0021,0035,0127,0272,0162,0001,0002,0165,
01457, SENA MADUREIRA ,0003,1082,0016,0103,0011,0038,0128,0271,0166,0000,0002,0168,
01457, SENA MADUREIRA ,0003,1090,0017,0101,0011,0045,0112,0262,0157,0003,0001,0161,
01457, SENA MADUREIRA ,0003,1090,0018,0087,0007,0063,0105,0260,0168,0002,0003,0173,
01457, SENA MADUREIRA ,0003,1104,0019,0073,0008,0040,0130,0247,0170,0000,0004,0174,
01457, SENA MADUREIRA ,0003,1104,0020,0106,0004,0042,0107,0256,0149,0000,0001,0150,
01457, SENA MADUREIRA ,0003,1104,0021,0094,0009,0039,0113,0251,0152,0000,0005,0157,
01457, SENA MADUREIRA ,0003,1112,0022,0092,0035,0045,0146,0288,0191,0002,0003,0196,
01457, SENA MADUREIRA ,0003,1120,0023,0110,0018,0057,0152,0324,0209,0003,0002,0214,
01457, SENA MADUREIRA ,0003,1120,0024,0116,0004,0049,0147,0315,0196,0000,0003,0199,
01457, SENA MADUREIRA ,0003,1139,0025,0068,0029,0045,0132,0254,0177,0004,0005,0186,
01457, SENA MADUREIRA ,0003,1139,0026,0078,0012,0039,0103,0224,0142,0002,0002,0146,
01457, SENA MADUREIRA ,0003,1147,0027,0111,0009,0033,0147,0296,0180,0004,0001,0185,
01457, SENA MADUREIRA ,0003,1147,0028,0098,0014,0047,0139,0285,0186,0001,0000,0187,
01457, SENA MADUREIRA ,0003,1155,0029,0142,0016,0042,0130,0316,0172,0000,0002,0174,
01457, SENA MADUREIRA ,0003,1155,0030,0126,0005,0053,0118,0304,0171,0003,0004,0178,
01457, SENA MADUREIRA ,0003,1023,0031,0096,0020,0059,0127,0285,0186,0000,0003,0189,
01457, SENA MADUREIRA ,0003,1171,0032,0112,0008,0060,0131,0304,0191,0000,0001,0192,
01457, SENA MADUREIRA ,0003,1171,0033,0110,0028,0057,0130,0299,0187,0001,0001,0189,
01457, SENA MADUREIRA ,0003,1180,0034,0134,0025,0043,0158,0337,0201,0000,0002,0203,
01457, SENA MADUREIRA ,0003,1180,0035,0124,0011,0040,0164,0335,0204,0002,0005,0211,
01457, SENA MADUREIRA ,0003,1180,0036,0117,0017,0037,0165,0322,0202,0002,0001,0205,
01457, SENA MADUREIRA ,0003,1198,0037,0114,0009,0047,0099,0265,0146,0003,0002,0151,
01457, SENA MADUREIRA ,0003,1198,0038,0100,0018,0045,0103,0252,0148,0002,0002,0152,
01457, SENA MADUREIRA ,0003,1015,0039,0140,0016,0062,0098,0307,0160,0002,0005,0167,
01457, SENA MADUREIRA ,0003,1015,0040,0149,0021,0060,0088,0304,0148,0004,0003,0155,
01457, SENA MADUREIRA ,0003,1112,0053,0098,0017,0048,0141,0292,0189,0001,0004,0194,
01457, SENA MADUREIRA ,0003,1155,0054,0093,0004,0045,0149,0288,0194,0000,0001,0195,
01457, SENA MADUREIRA ,0003,1244,0055,0086,0020,0037,0140,0267,0177,0002,0002,0181,
01457, SENA MADUREIRA ,0003,1244,0056,0086,0017,0049,0137,0274,0186,0001,0001,0188,
01457, SENA MADUREIRA ,0003,1120,0057,0115,0008,0049,0146,0313,0195,0001,0002,0198,
01457, SENA MADUREIRA ,0003,1015,0061,0128,0007,0050,0108,0288,0158,0000,0002,0160,
01457, SENA MADUREIRA ,0003,1520,0062,0056,0011,0049,0146,0258,0195,0002,0005,0202,
01457, SENA MADUREIRA ,0003,1252,0063,0083,0019,0064,0141,0293,0205,0002,0003,0210,
01457, SENA MADUREIRA ,0003,1244,0064,0088,0015,0039,0128,0255,0167,0000,0000,0167,
01457, SENA MADUREIRA ,0003,1112,0066,0103,0010,0039,0137,0282,0176,0001,0002,0179,
01457, SENA MADUREIRA ,0003,1252,0067,0098,0004,0046,0142,0289,0188,0000,0003,0191,
01457, SENA MADUREIRA ,0003,1066,0068,0105,0011,0054,0164,0324,0218,0000,0001,0219,
01457, SENA MADUREIRA ,0003,1333,0069,0075,0010,0043,0139,0262,0182,0002,0003,0187,
01457, SENA MADUREIRA ,0003,1031,0070,0090,0036,0062,0152,0307,0214,0001,0002,0217,
01457, SENA MADUREIRA ,0003,1015,0071,0112,0005,0062,0102,0279,0164,0002,0001,0167,
01457, SENA MADUREIRA ,0003,1066,0073,0089,0019,0042,0185,0320,0227,0002,0002,0231,
01457, SENA MADUREIRA ,0003,1112,0074,0091,0006,0039,0145,0276,0184,0000,0001,0185,
01457, SENA MADUREIRA ,0003,1252,0075,0109,0017,0043,0141,0296,0184,0002,0001,0187,
01457, SENA MADUREIRA ,0003,1120,0078,0106,0009,0060,0145,0317,0205,0001,0005,0211,
01457, SENA MADUREIRA ,0003,1104,0079,0102,0016,0044,0097,0248,0141,0003,0002,0146,
01457, SENA MADUREIRA ,0003,1112,0080,0122,0019,0033,0121,0279,0154,0001,0002,0157,
01457, SENA MADUREIRA ,0003,1023,0081,0102,0006,0051,0105,0259,0156,0000,0001,0157,
01457, SENA MADUREIRA ,0003,1503,0082,0122,0012,0040,0116,0282,0156,0001,0003,0160,
01457, SENA MADUREIRA ,0003,1279,0083,0113,0018,0061,0126,0301,0187,0001,0000,0188,
01457, SENA MADUREIRA ,0003,1015,0084,0105,0004,0059,0113,0278,0172,0000,0001,0173,
01457, SENA MADUREIRA ,0003,1287,0085,0108,0008,0037,0118,0267,0155,0003,0001,0159,
01457, SENA MADUREIRA ,0003,1295,0086,0104,0012,0087,0122,0317,0209,0001,0003,0213,
01457, SENA MADUREIRA ,0003,1252,0090,0076,0006,0057,0146,0285,0203,0002,0004,0209,
01457, SENA MADUREIRA ,0003,1279,0091,0097,0013,0043,0139,0287,0182,0002,0006,0190,
01457, SENA MADUREIRA ,0003,1309,0092,0136,0008,0053,0129,0319,0182,0000,0001,0183,
01457, SENA MADUREIRA ,0003,1155,0093,0076,0004,0027,0161,0265,0188,0000,0001,0189,
01457, SENA MADUREIRA ,0003,1333,0094,0082,0015,0038,0132,0253,0170,0001,0000,0171,
01457, SENA MADUREIRA ,0003,1392,0097,0086,0008,0041,0131,0259,0172,0000,0001,0173,
01457, SENA MADUREIRA ,0003,1341,0098,0153,0006,0042,0069,0265,0111,0000,0001,0112,
01457, SENA MADUREIRA ,0003,1295,0099,0121,0016,0076,0112,0312,0188,0001,0002,0191,
01457, SENA MADUREIRA ,0003,1376,0101,0114,0007,0080,0121,0323,0201,0004,0004,0209,
01457, SENA MADUREIRA ,0003,1384,0103,0100,0006,0013,0124,0241,0137,0001,0003,0141,
01457, SENA MADUREIRA ,0003,1309,0104,0126,0012,0060,0116,0305,0176,0001,0002,0179,
01457, SENA MADUREIRA ,0003,1511,0105,0134,0011,0065,0102,0307,0167,0003,0003,0173,
01457, SENA MADUREIRA ,0003,1023,0106,0097,0004,0036,0120,0255,0156,0001,0001,0158,
01457, SENA MADUREIRA ,0003,1392,0108,0097,0019,0052,0147,0297,0199,0000,0001,0200,
01457, SENA MADUREIRA ,0003,1406,0109,0086,0007,0014,0130,0231,0144,0000,0001,0145,
01457, SENA MADUREIRA ,0003,1309,0110,0127,0012,0050,0101,0282,0151,0003,0001,0155,
01457, SENA MADUREIRA ,0003,1040,0112,0091,0002,0041,0127,0262,0168,0002,0001,0171,
01457, SENA MADUREIRA ,0003,1180,0113,0109,0011,0037,0131,0280,0168,0002,0001,0171,
01457, SENA MADUREIRA ,0003,1333,0114,0092,0002,0027,0108,0229,0135,0000,0002,0137,
01457, SENA MADUREIRA ,0003,1449,0115,0098,0003,0047,0145,0293,0192,0001,0002,0195,
01457, SENA MADUREIRA ,0003,1473,0116,0113,0009,0036,0133,0289,0169,0005,0002,0176,
01457, SENA MADUREIRA ,0003,1430,0117,0095,0013,0042,0146,0287,0188,0003,0001,0192,
01457, SENA MADUREIRA ,0003,1465,0118,0121,0005,0035,0110,0270,0145,0001,0003,0149,
01457, SENA MADUREIRA ,0003,1481,0119,0109,0010,0032,0136,0280,0168,0000,0003,0171,
01457, SENA MADUREIRA ,0003,1457,0120,0120,0018,0042,0097,0264,0139,0003,0002,0144,
01457, SENA MADUREIRA ,0003,1414,0121,0112,0012,0044,0109,0269,0153,0003,0001,0157,
01457, SENA MADUREIRA ,0003,1422,0123,0090,0011,0044,0148,0288,0192,0003,0003,0198,
01457, SENA MADUREIRA ,0003,1392,0127,0087,0024,0040,0146,0278,0186,0002,0003,0191,
01457, SENA MADUREIRA ,0003,1392,0128,0100,0035,0060,0166,0330,0226,0002,0002,0230,
01457, SENA MADUREIRA ,0003,1376,0129,0143,0021,0041,0120,0307,0161,0000,0003,0164,
01457, SENA MADUREIRA ,0003,1481,0131,0140,0006,0044,0094,0281,0138,0001,0002,0141,
01457, SENA MADUREIRA ,0003,1473,0136,0101,0007,0055,0130,0294,0185,0002,0006,0193,
01457, SENA MADUREIRA ,0003,1384,0137,0092,0009,0022,0113,0230,0135,0000,0003,0138,
01457, SENA MADUREIRA ,0003,1295,0138,0105,0007,0064,0116,0291,0180,0001,0005,0186,
01457, SENA MADUREIRA ,0003,1538,0141,0066,0011,0032,0070,0172,0102,0002,0002,0106,
01457, SENA MADUREIRA ,0003,1554,0142,0122,0011,0044,0087,0257,0131,0000,0004,0135,
01457, SENA MADUREIRA ,0003,1139,0144,0045,0006,0041,0099,0185,0140,0000,0000,0140,
01457, SENA MADUREIRA ,0003,1546,0146,0059,0007,0023,0052,0136,0075,0000,0002,0077,
01457, SENA MADUREIRA ,0003,1015,0147,0114,0007,0050,0100,0268,0150,0001,0003,0154,
01457, SENA MADUREIRA ,0003,1341,0148,0114,0000,0013,0016,0143,0029,0000,0000,0029,
01457, SENA MADUREIRA ,0003,1287,0149,0052,0001,0010,0030,0092,0040,0000,0000,0040,
01457, SENA MADUREIRA ,0003,1562,0151,0017,0012,0017,0066,0101,0083,0001,0000,0084,
01457, SENA MADUREIRA ,0003,1031,0155,0029,0001,0014,0062,0105,0076,0000,0000,0076,
01473, TARAUACÁ ,0005,1015,0001,0153,0015,0062,0103,0323,0165,0002,0003,0170,
01473, TARAUACÁ ,0005,1015,0002,0130,0010,0090,0102,0329,0192,0004,0003,0199,
01473, TARAUACÁ ,0005,1015,0003,0133,0012,0073,0108,0318,0181,0001,0003,0185,
01473, TARAUACÁ ,0005,1074,0004,0124,0016,0064,0116,0310,0180,0003,0003,0186,
01473, TARAUACÁ ,0005,1023,0005,0142,0000,0070,0106,0322,0176,0002,0002,0180,
01473, TARAUACÁ ,0005,1074,0006,0124,0016,0053,0122,0303,0175,0001,0003,0179,
01473, TARAUACÁ ,0005,1031,0007,0120,0011,0065,0104,0297,0169,0004,0004,0177,
01473, TARAUACÁ ,0005,1031,0008,0132,0018,0075,0093,0304,0168,0002,0002,0172,
01473, TARAUACÁ ,0005,1171,0009,0136,0015,0066,0100,0308,0166,0000,0006,0172,
01473, TARAUACÁ ,0005,1171,0010,0118,0006,0065,0112,0297,0177,0000,0002,0179,
01473, TARAUACÁ ,0005,1171,0011,0098,0032,0074,0115,0290,0189,0001,0002,0192,
01473, TARAUACÁ ,0005,1074,0012,0133,0011,0062,0111,0310,0173,0002,0002,0177,
01473, TARAUACÁ ,0005,1236,0013,0146,0033,0059,0116,0325,0175,0003,0001,0179,
01473, TARAUACÁ ,0005,1031,0014,0121,0006,0063,0107,0297,0170,0003,0003,0176,
01473, TARAUACÁ ,0005,1082,0015,0103,0009,0065,0091,0265,0156,0002,0004,0162,
01473, TARAUACÁ ,0005,1112,0016,0098,0025,0047,0085,0238,0132,0001,0007,0140,
01473, TARAUACÁ ,0005,1147,0017,0144,0009,0067,0093,0312,0160,0004,0004,0168,
01473, TARAUACÁ ,0005,1112,0018,0095,0007,0061,0079,0237,0140,0000,0002,0142,
01473, TARAUACÁ ,0005,1120,0019,0137,0014,0082,0088,0313,0170,0003,0003,0176,
01473, TARAUACÁ ,0005,1112,0020,0104,0011,0057,0076,0247,0133,0005,0005,0143,
01473, TARAUACÁ ,0005,1236,0021,0113,0009,0084,0095,0297,0179,0000,0005,0184,
01473, TARAUACÁ ,0005,1147,0022,0115,0010,0065,0126,0309,0191,0003,0000,0194,
01473, TARAUACÁ ,0005,1449,0023,0140,0016,0059,0110,0319,0169,0006,0004,0179,
01473, TARAUACÁ ,0005,1031,0024,0140,0018,0066,0092,0304,0158,0003,0003,0164,
01473, TARAUACÁ ,0005,1171,0025,0115,0002,0066,0108,0294,0174,0002,0003,0179,
01473, TARAUACÁ ,0005,1171,0026,0093,0005,0053,0122,0278,0175,0005,0005,0185,
01473, TARAUACÁ ,0005,1503,0029,0152,0005,0071,0107,0334,0178,0001,0003,0182,
01473, TARAUACÁ ,0005,1082,0030,0116,0008,0061,0095,0279,0156,0002,0005,0163,
01473, TARAUACÁ ,0005,1244,0031,0135,0012,0064,0129,0333,0193,0003,0002,0198,
01473, TARAUACÁ ,0005,1244,0033,0115,0011,0075,0147,0341,0222,0003,0001,0226,
01473, TARAUACÁ ,0005,1074,0034,0109,0005,0063,0118,0294,0181,0001,0003,0185,
01473, TARAUACÁ ,0005,1228,0035,0077,0007,0062,0064,0206,0126,0002,0001,0129,
01473, TARAUACÁ ,0005,1236,0036,0110,0016,0078,0101,0294,0179,0001,0004,0184,
01473, TARAUACÁ ,0005,1031,0038,0134,0003,0057,0100,0296,0157,0001,0004,0162,
01473, TARAUACÁ ,0005,1236,0039,0102,0005,0077,0105,0288,0182,0001,0003,0186,
01473, TARAUACÁ ,0005,1236,0040,0108,0023,0090,0098,0300,0188,0001,0003,0192,
01473, TARAUACÁ ,0005,1074,0041,0115,0016,0067,0115,0303,0182,0001,0005,0188,
01473, TARAUACÁ ,0005,1350,0042,0106,0020,0079,0110,0309,0189,0005,0009,0203,
01473, TARAUACÁ ,0005,1082,0043,0098,0008,0063,0103,0267,0166,0001,0002,0169,
01473, TARAUACÁ ,0005,1112,0044,0075,0012,0051,0093,0224,0144,0002,0003,0149,
01473, TARAUACÁ ,0005,1449,0047,0117,0002,0070,0108,0307,0178,0005,0007,0190,
01473, TARAUACÁ ,0005,1287,0048,0115,0019,0057,0106,0283,0163,0002,0003,0168,
01473, TARAUACÁ ,0005,1317,0049,0135,0020,0082,0092,0313,0174,0001,0003,0178,
01473, TARAUACÁ ,0005,1171,0050,0133,0005,0067,0086,0290,0153,0001,0003,0157,
01473, TARAUACÁ ,0005,1015,0051,0133,0004,0064,0097,0300,0161,0003,0003,0167,
01473, TARAUACÁ ,0005,1244,0053,0129,0012,0071,0130,0338,0201,0000,0008,0209,
01473, TARAUACÁ ,0005,1260,0054,0105,0006,0085,0049,0245,0134,0001,0005,0140,
01473, TARAUACÁ ,0005,1252,0055,0088,0034,0105,0068,0270,0173,0005,0004,0182,
01473, TARAUACÁ ,0005,1325,0058,0106,0003,0033,0071,0214,0104,0002,0002,0108,
01473, TARAUACÁ ,0005,1325,0060,0069,0002,0043,0079,0194,0122,0002,0001,0125,
01473, TARAUACÁ ,0005,1260,0061,0099,0009,0082,0051,0234,0133,0000,0002,0135,
01473, TARAUACÁ ,0005,1341,0063,0115,0004,0015,0083,0216,0098,0000,0003,0101,
01473, TARAUACÁ ,0005,1252,0064,0074,0009,0104,0090,0269,0194,0001,0000,0195,
01473, TARAUACÁ ,0005,1015,0068,0123,0007,0079,0094,0298,0173,0000,0002,0175,
01473, TARAUACÁ ,0005,1015,0069,0128,0016,0061,0110,0307,0171,0003,0005,0179,
01473, TARAUACÁ ,0005,1074,0070,0109,0004,0055,0112,0280,0167,0002,0002,0171,
01473, TARAUACÁ ,0005,1350,0071,0136,0011,0079,0102,0319,0181,0000,0002,0183,
01473, TARAUACÁ ,0005,1120,0072,0111,0003,0068,0104,0288,0172,0003,0002,0177,
01473, TARAUACÁ ,0005,1376,0074,0070,0003,0154,0002,0230,0156,0000,0004,0160,
01473, TARAUACÁ ,0005,1171,0077,0106,0003,0055,0106,0270,0161,0002,0001,0164,
01473, TARAUACÁ ,0005,1082,0078,0097,0004,0062,0093,0262,0155,0003,0007,0165,
01473, TARAUACÁ ,0005,1260,0079,0094,0005,0075,0049,0221,0124,0002,0001,0127,
01473, TARAUACÁ ,0005,1236,0080,0106,0024,0079,0093,0282,0172,0001,0003,0176,
01473, TARAUACÁ ,0005,1350,0082,0136,0005,0068,0099,0308,0167,0001,0004,0172,
01473, TARAUACÁ ,0005,1171,0083,0121,0005,0061,0092,0275,0153,0000,0001,0154,
01473, TARAUACÁ ,0005,1236,0084,0097,0003,0069,0104,0274,0173,0002,0002,0177,
01473, TARAUACÁ ,0005,1147,0085,0104,0006,0069,0090,0272,0159,0002,0007,0168,
01473, TARAUACÁ ,0005,1147,0087,0102,0010,0071,0094,0269,0165,0001,0001,0167,
01473, TARAUACÁ ,0005,1015,0088,0120,0018,0065,0099,0289,0164,0004,0001,0169,
01473, TARAUACÁ ,0005,1074,0090,0105,0009,0064,0106,0279,0170,0002,0002,0174,
01473, TARAUACÁ ,0005,1031,0091,0130,0004,0076,0071,0280,0147,0000,0003,0150,
01473, TARAUACÁ ,0005,1341,0092,0103,0014,0020,0091,0214,0111,0000,0000,0111,
01473, TARAUACÁ ,0005,1287,0093,0118,0005,0055,0079,0260,0134,0002,0006,0142,
01473, TARAUACÁ ,0005,1350,0094,0140,0005,0076,0091,0310,0167,0000,0003,0170,
01473, TARAUACÁ ,0005,1449,0095,0131,0007,0054,0111,0300,0165,0003,0001,0169,
01473, TARAUACÁ ,0005,1031,0098,0122,0006,0068,0096,0288,0164,0000,0002,0166,
01473, TARAUACÁ ,0005,1228,0101,0081,0006,0032,0056,0170,0088,0000,0001,0089,
01473, TARAUACÁ ,0005,1368,0102,0172,0009,0106,0015,0295,0121,0000,0002,0123,
01473, TARAUACÁ ,0005,1384,0103,0080,0006,0084,0006,0175,0090,0000,0005,0095,
01473, TARAUACÁ ,0005,1392,0104,0095,0007,0232,0004,0341,0236,0001,0009,0246,
01473, TARAUACÁ ,0005,1406,0105,0054,0006,0013,0061,0129,0074,0000,0001,0075,
01473, TARAUACÁ ,0005,1074,0106,0117,0011,0061,0108,0291,0169,0002,0003,0174,
01473, TARAUACÁ ,0005,1082,0107,0102,0006,0056,0075,0237,0131,0002,0002,0135,
01473, TARAUACÁ ,0005,1350,0108,0137,0017,0078,0078,0297,0156,0001,0003,0160,
01473, TARAUACÁ ,0005,1422,0109,0035,0004,0015,0037,0088,0052,0000,0001,0053,
01473, TARAUACÁ ,0005,1244,0110,0132,0008,0079,0124,0340,0203,0003,0002,0208,
01473, TARAUACÁ ,0005,1430,0111,0086,0012,0060,0096,0248,0156,0002,0004,0162,
01473, TARAUACÁ ,0005,1252,0114,0092,0008,0093,0079,0269,0172,0004,0001,0177,
01473, TARAUACÁ ,0005,1260,0115,0126,0001,0057,0038,0227,0095,0003,0003,0101,
01473, TARAUACÁ ,0005,1015,0116,0128,0002,0072,0097,0300,0169,0000,0003,0172,
01473, TARAUACÁ ,0005,1350,0117,0166,0009,0052,0085,0306,0137,0001,0002,0140,
01473, TARAUACÁ ,0005,1449,0119,0132,0009,0071,0102,0309,0173,0003,0001,0177,
01473, TARAUACÁ ,0005,1430,0120,0085,0013,0066,0113,0270,0179,0003,0003,0185,
01473, TARAUACÁ ,0005,1260,0121,0100,0006,0067,0056,0227,0123,0000,0004,0127,
01473, TARAUACÁ ,0005,1449,0124,0150,0008,0058,0072,0281,0130,0000,0001,0131,
01473, TARAUACÁ ,0005,1449,0127,0130,0010,0068,0084,0284,0152,0001,0001,0154,
01473, TARAUACÁ ,0005,1430,0128,0063,0008,0047,0097,0211,0144,0003,0001,0148,
01473, TARAUACÁ ,0005,1260,0129,0091,0010,0063,0052,0207,0115,0001,0000,0116,
01473, TARAUACÁ ,0005,1252,0130,0067,0003,0074,0073,0219,0147,0002,0003,0152,
01473, TARAUACÁ ,0005,1481,0133,0050,0002,0042,0038,0131,0080,0000,0001,0081,
01473, TARAUACÁ ,0005,1465,0134,0027,0002,0024,0058,0109,0082,0000,0000,0082,
01490, XAPURI ,0002,1015,0001,0053,0036,0059,0101,0218,0160,0001,0004,0165,
01490, XAPURI ,0002,1015,0002,0063,0030,0051,0099,0216,0150,0000,0003,0153,
01490, XAPURI ,0002,1015,0003,0055,0045,0073,0088,0218,0161,0000,0002,0163,
01490, XAPURI ,0002,1015,0004,0062,0019,0064,0087,0216,0151,0000,0003,0154,
01490, XAPURI ,0002,1252,0005,0056,0022,0064,0110,0233,0174,0001,0002,0177,
01490, XAPURI ,0002,1031,0006,0057,0021,0074,0105,0242,0179,0001,0005,0185,
01490, XAPURI ,0002,1031,0007,0059,0027,0068,0114,0244,0182,0001,0002,0185,
01490, XAPURI ,0002,1031,0008,0074,0019,0068,0095,0243,0163,0003,0003,0169,
01490, XAPURI ,0002,1031,0009,0045,0039,0080,0108,0242,0188,0002,0007,0197,
01490, XAPURI ,0002,1252,0010,0055,0006,0054,0114,0229,0168,0001,0005,0174,
01490, XAPURI ,0002,1058,0011,0058,0039,0074,0109,0242,0183,0000,0001,0184,
01490, XAPURI ,0002,1287,0012,0068,0016,0094,0110,0276,0204,0001,0003,0208,
01490, XAPURI ,0002,1074,0013,0054,0040,0089,0129,0281,0218,0000,0009,0227,
01490, XAPURI ,0002,1074,0015,0050,0019,0085,0120,0258,0205,0001,0002,0208,
01490, XAPURI ,0002,1139,0016,0048,0017,0053,0095,0196,0148,0000,0000,0148,
01490, XAPURI ,0002,1015,0017,0043,0021,0066,0101,0216,0167,0000,0006,0173,
01490, XAPURI ,0002,1031,0018,0057,0020,0067,0112,0240,0179,0001,0003,0183,
01490, XAPURI ,0002,1139,0019,0037,0010,0065,0091,0196,0156,0001,0002,0159,
01490, XAPURI ,0002,1015,0020,0049,0012,0065,0097,0215,0162,0001,0003,0166,
01490, XAPURI ,0002,1252,0021,0059,0015,0059,0093,0217,0152,0003,0003,0158,
01490, XAPURI ,0002,1155,0023,0030,0006,0048,0054,0136,0102,0002,0002,0106,
01490, XAPURI ,0002,1155,0024,0070,0035,0061,0102,0238,0163,0000,0005,0168,
01490, XAPURI ,0002,1082,0025,0062,0020,0075,0109,0247,0184,0000,0001,0185,
01490, XAPURI ,0002,1082,0026,0069,0023,0071,0105,0245,0176,0000,0000,0176,
01490, XAPURI ,0002,1082,0027,0065,0024,0070,0098,0240,0168,0003,0004,0175,
01490, XAPURI ,0002,1082,0029,0065,0031,0071,0104,0245,0175,0000,0005,0180,
01490, XAPURI ,0002,1074,0030,0077,0015,0062,0122,0269,0184,0002,0006,0192,
01490, XAPURI ,0002,1082,0031,0066,0014,0056,0113,0238,0169,0001,0002,0172,
01490, XAPURI ,0002,1171,0032,0047,0011,0098,0095,0253,0193,0002,0011,0206,
01490, XAPURI ,0002,1180,0033,0068,0010,0114,0024,0207,0138,0000,0001,0139,
01490, XAPURI ,0002,1198,0034,0048,0027,0057,0040,0149,0097,0000,0004,0101,
01490, XAPURI ,0002,1201,0035,0037,0018,0109,0065,0211,0174,0000,0000,0174,
01490, XAPURI ,0002,1210,0036,0026,0026,0016,0088,0133,0104,0001,0002,0107,
01490, XAPURI ,0002,1228,0037,0061,0018,0060,0089,0212,0149,0000,0002,0151,
01490, XAPURI ,0002,1201,0039,0054,0018,0080,0078,0214,0158,0001,0001,0160,
01490, XAPURI ,0002,1082,0041,0075,0027,0070,0102,0249,0172,0002,0000,0174,
01490, XAPURI ,0002,1031,0042,0075,0004,0061,0107,0246,0168,0001,0002,0171,
01490, XAPURI ,0002,1279,0045,0081,0026,0078,0131,0294,0209,0002,0002,0213,
01490, XAPURI ,0002,1236,0046,0060,0039,0060,0106,0229,0166,0001,0002,0169,
01490, XAPURI ,0002,1287,0048,0072,0024,0069,0132,0277,0201,0002,0002,0205,
01490, XAPURI ,0002,1260,0050,0043,0016,0053,0102,0203,0155,0002,0003,0160,
01490, XAPURI ,0002,1244,0051,0047,0015,0073,0079,0203,0152,0003,0001,0156,
01490, XAPURI ,0002,1260,0052,0052,0017,0043,0094,0194,0137,0001,0004,0142,
01490, XAPURI ,0002,1082,0053,0063,0019,0072,0112,0247,0184,0000,0000,0184,
01490, XAPURI ,0002,1082,0054,0080,0029,0064,0105,0252,0169,0001,0002,0172,
01490, XAPURI ,0002,1279,0055,0064,0031,0093,0127,0286,0220,0000,0002,0222,
01490, XAPURI ,0002,1236,0057,0050,0013,0073,0103,0232,0176,0003,0003,0182,
01490, XAPURI ,0002,1279,0058,0060,0021,0094,0130,0292,0224,0002,0006,0232,
01490, XAPURI ,0002,1279,0060,0087,0038,0104,0135,0329,0239,0001,0002,0242,
01490, XAPURI ,0002,1082,0061,0062,0006,0077,0096,0241,0173,0002,0004,0179,
01490, XAPURI ,0002,1031,0062,0070,0025,0056,0106,0238,0162,0000,0006,0168,
01490, XAPURI ,0002,1244,0064,0044,0013,0074,0086,0209,0160,0003,0002,0165,
01511, PLÁCIDO DE CASTRO ,0008,1040,0001,0060,0009,0058,0125,0245,0183,0001,0001,0185,
01511, PLÁCIDO DE CASTRO ,0008,1546,0002,0083,0011,0047,0095,0227,0142,0000,0002,0144,
01511, PLÁCIDO DE CASTRO ,0008,1023,0003,0069,0026,0040,0112,0227,0152,0004,0002,0158,
01511, PLÁCIDO DE CASTRO ,0008,1023,0004,0072,0013,0043,0100,0219,0143,0003,0001,0147,
01511, PLÁCIDO DE CASTRO ,0008,1031,0005,0079,0029,0053,0128,0263,0181,0001,0002,0184,
01511, PLÁCIDO DE CASTRO ,0008,1058,0007,0031,0016,0026,0077,0136,0103,0002,0000,0105,
01511, PLÁCIDO DE CASTRO ,0008,1074,0010,0061,0032,0047,0090,0205,0137,0003,0004,0144,
01511, PLÁCIDO DE CASTRO ,0008,1082,0011,0076,0019,0050,0119,0251,0169,0004,0002,0175,
01511, PLÁCIDO DE CASTRO ,0008,1104,0013,0065,0031,0045,0134,0247,0179,0000,0003,0182,
01511, PLÁCIDO DE CASTRO ,0008,1104,0014,0066,0028,0037,0135,0244,0172,0004,0002,0178,
01511, PLÁCIDO DE CASTRO ,0008,1104,0015,0061,0016,0051,0127,0245,0178,0002,0004,0184,
01511, PLÁCIDO DE CASTRO ,0008,1112,0016,0096,0020,0048,0141,0288,0189,0001,0002,0192,
01511, PLÁCIDO DE CASTRO ,0008,1112,0017,0095,0028,0047,0134,0282,0181,0003,0003,0187,
01511, PLÁCIDO DE CASTRO ,0008,1546,0018,0069,0019,0033,0120,0226,0153,0000,0004,0157,
01511, PLÁCIDO DE CASTRO ,0008,1155,0023,0087,0024,0089,0153,0336,0242,0002,0005,0249,
01511, PLÁCIDO DE CASTRO ,0008,1104,0024,0073,0029,0048,0120,0244,0168,0003,0000,0171,
01511, PLÁCIDO DE CASTRO ,0008,1058,0042,0081,0036,0060,0123,0269,0183,0002,0003,0188,
01511, PLÁCIDO DE CASTRO ,0008,1724,0043,0058,0023,0031,0110,0204,0141,0002,0003,0146,
01511, PLÁCIDO DE CASTRO ,0008,1074,0045,0064,0026,0043,0093,0203,0136,0002,0001,0139,
01511, PLÁCIDO DE CASTRO ,0008,1651,0046,0048,0025,0032,0096,0180,0128,0003,0001,0132,
01511, PLÁCIDO DE CASTRO ,0008,1082,0052,0069,0020,0053,0129,0253,0182,0002,0000,0184,
01511, PLÁCIDO DE CASTRO ,0008,1627,0054,0053,0013,0061,0131,0254,0192,0005,0004,0201,
01511, PLÁCIDO DE CASTRO ,0008,1546,0055,0067,0019,0046,0110,0226,0156,0002,0001,0159,
01511, PLÁCIDO DE CASTRO ,0008,1724,0061,0054,0019,0048,0134,0244,0182,0001,0007,0190,
01511, PLÁCIDO DE CASTRO ,0008,1651,0066,0040,0037,0041,0126,0210,0167,0002,0001,0170,
01511, PLÁCIDO DE CASTRO ,0008,1082,0075,0090,0014,0035,0114,0244,0149,0002,0003,0154,
01511, PLÁCIDO DE CASTRO ,0008,1546,0076,0062,0016,0051,0106,0223,0157,0002,0002,0161,
01511, PLÁCIDO DE CASTRO ,0008,1031,0080,0060,0021,0054,0143,0263,0197,0001,0005,0203,
01511, PLÁCIDO DE CASTRO ,0008,1546,0081,0072,0024,0043,0103,0222,0146,0002,0002,0150,
01511, PLÁCIDO DE CASTRO ,0008,1112,0086,0074,0040,0064,0143,0287,0207,0001,0005,0213,
01511, PLÁCIDO DE CASTRO ,0008,1600,0096,0086,0017,0052,0174,0320,0226,0005,0003,0234,
01511, PLÁCIDO DE CASTRO ,0008,1627,0111,0078,0020,0049,0121,0250,0170,0001,0001,0172,
01511, PLÁCIDO DE CASTRO ,0008,1082,0112,0087,0022,0045,0118,0251,0163,0000,0001,0164,
01511, PLÁCIDO DE CASTRO ,0008,1546,0113,0073,0016,0042,0105,0223,0147,0002,0001,0150,
01511, PLÁCIDO DE CASTRO ,0008,1112,0114,0080,0025,0050,0149,0283,0199,0002,0002,0203,
01511, PLÁCIDO DE CASTRO ,0008,1600,0121,0042,0011,0030,0089,0162,0119,0000,0001,0120,
01511, PLÁCIDO DE CASTRO ,0008,1546,0128,0067,0016,0037,0113,0222,0150,0003,0002,0155,
01511, PLÁCIDO DE CASTRO ,0008,1074,0137,0057,0016,0051,0095,0205,0146,0000,0002,0148,
01511, PLÁCIDO DE CASTRO ,0008,1112,0138,0088,0011,0050,0137,0279,0187,0001,0003,0191,
01511, PLÁCIDO DE CASTRO ,0008,1619,0144,0094,0026,0044,0142,0286,0186,0002,0004,0192,
01511, PLÁCIDO DE CASTRO ,0008,1562,0151,0044,0041,0016,0135,0201,0151,0000,0006,0157,
01511, PLÁCIDO DE CASTRO ,0008,1589,0155,0032,0016,0045,0119,0198,0164,0000,0002,0166,
01511, PLÁCIDO DE CASTRO ,0008,1570,0156,0040,0025,0064,0084,0190,0148,0000,0002,0150,
01511, PLÁCIDO DE CASTRO ,0008,1597,0165,0077,0010,0040,0179,0296,0219,0000,0000,0219,
01511, PLÁCIDO DE CASTRO ,0008,1600,0173,0063,0012,0031,0081,0177,0112,0000,0002,0114,
01511, PLÁCIDO DE CASTRO ,0008,1589,0201,0053,0009,0028,0096,0178,0124,0001,0000,0125,
01511, PLÁCIDO DE CASTRO ,0008,1104,0202,0070,0021,0035,0140,0246,0175,0000,0001,0176,
01511, PLÁCIDO DE CASTRO ,0008,1570,0203,0070,0013,0039,0078,0189,0117,0001,0001,0119,
01511, PLÁCIDO DE CASTRO ,0008,1694,0211,0055,0007,0025,0051,0132,0076,0000,0001,0077,
01511, PLÁCIDO DE CASTRO ,0008,1562,0234,0070,0019,0012,0111,0198,0123,0001,0004,0128,
01511, PLÁCIDO DE CASTRO ,0008,1074,0253,0082,0018,0040,0086,0208,0126,0000,0000,0126,
01511, PLÁCIDO DE CASTRO ,0008,1589,0259,0047,0012,0023,0091,0162,0114,0001,0000,0115,
01511, PLÁCIDO DE CASTRO ,0008,1104,0263,0099,0018,0034,0111,0247,0145,0001,0002,0148,
01538, SENADOR GUIOMARD ,0008,1015,0025,0074,0008,0060,0149,0288,0209,0003,0002,0214,
01538, SENADOR GUIOMARD ,0008,1023,0027,0044,0006,0072,0140,0261,0212,0002,0003,0217,
01538, SENADOR GUIOMARD ,0008,1031,0028,0073,0005,0053,0135,0263,0188,0001,0001,0190,
01538, SENADOR GUIOMARD ,0008,1040,0029,0067,0010,0063,0188,0324,0251,0001,0005,0257,
01538, SENADOR GUIOMARD ,0008,1031,0030,0077,0008,0038,0152,0270,0190,0002,0001,0193,
01538, SENADOR GUIOMARD ,0008,1066,0031,0050,0008,0057,0126,0239,0183,0004,0002,0189,
01538, SENADOR GUIOMARD ,0008,1074,0032,0056,0013,0042,0124,0229,0166,0007,0000,0173,
01538, SENADOR GUIOMARD ,0008,1082,0033,0053,0021,0065,0153,0280,0218,0001,0008,0227,
01538, SENADOR GUIOMARD ,0008,1082,0034,0064,0010,0068,0139,0276,0207,0003,0002,0212,
01538, SENADOR GUIOMARD ,0008,1090,0035,0052,0021,0045,0122,0220,0167,0001,0000,0168,
01538, SENADOR GUIOMARD ,0008,1090,0036,0053,0020,0048,0113,0218,0161,0003,0001,0165,
01538, SENADOR GUIOMARD ,0008,1031,0039,0082,0002,0044,0139,0272,0183,0002,0005,0190,
01538, SENADOR GUIOMARD ,0008,1074,0040,0054,0007,0053,0110,0224,0163,0003,0004,0170,
01538, SENADOR GUIOMARD ,0008,1082,0041,0066,0004,0058,0151,0279,0209,0003,0001,0213,
01538, SENADOR GUIOMARD ,0008,1031,0044,0070,0007,0045,0143,0263,0188,0002,0003,0193,
01538, SENADOR GUIOMARD ,0008,1333,0049,0093,0009,0049,0152,0298,0201,0002,0002,0205,
01538, SENADOR GUIOMARD ,0008,1147,0050,0035,0016,0027,0129,0195,0156,0001,0003,0160,
01538, SENADOR GUIOMARD ,0008,1040,0053,0079,0008,0062,0169,0317,0231,0002,0005,0238,
01538, SENADOR GUIOMARD ,0008,1074,0057,0058,0009,0043,0120,0224,0163,0000,0003,0166,
01538, SENADOR GUIOMARD ,0008,1481,0062,0083,0010,0051,0157,0298,0208,0004,0003,0215,
01538, SENADOR GUIOMARD ,0008,1074,0063,0051,0009,0044,0124,0224,0168,0002,0003,0173,
01538, SENADOR GUIOMARD ,0008,1155,0067,0047,0006,0065,0132,0248,0197,0004,0000,0201,
01538, SENADOR GUIOMARD ,0008,1074,0068,0051,0003,0043,0124,0228,0167,0006,0004,0177,
01538, SENADOR GUIOMARD ,0008,1163,0069,0037,0029,0036,0120,0198,0156,0001,0004,0161,
01538, SENADOR GUIOMARD ,0008,1171,0070,0063,0042,0033,0196,0293,0229,0001,0000,0230,
01538, SENADOR GUIOMARD ,0008,1155,0073,0059,0002,0050,0132,0250,0182,0001,0008,0191,
01538, SENADOR GUIOMARD ,0008,1422,0078,0073,0008,0041,0164,0281,0205,0001,0002,0208,
01538, SENADOR GUIOMARD ,0008,1155,0082,0057,0010,0057,0131,0252,0188,0005,0002,0195,
01538, SENADOR GUIOMARD ,0008,1155,0090,0047,0004,0057,0137,0249,0194,0004,0004,0202,
01538, SENADOR GUIOMARD ,0008,1155,0091,0062,0007,0047,0131,0247,0178,0003,0004,0185,
01538, SENADOR GUIOMARD ,0008,1406,0092,0066,0011,0070,0174,0323,0244,0009,0004,0257,
01538, SENADOR GUIOMARD ,0008,1481,0097,0082,0008,0044,0172,0303,0216,0001,0004,0221,
01538, SENADOR GUIOMARD ,0008,1201,0098,0076,0031,0032,0188,0303,0220,0003,0004,0227,
01538, SENADOR GUIOMARD ,0008,1163,0100,0042,0023,0030,0116,0195,0146,0004,0003,0153,
01538, SENADOR GUIOMARD ,0008,1392,0104,0045,0007,0034,0119,0199,0153,0001,0000,0154,
01538, SENADOR GUIOMARD ,0008,1066,0116,0062,0011,0049,0122,0240,0171,0002,0005,0178,
01538, SENADOR GUIOMARD ,0008,1074,0118,0042,0008,0048,0127,0225,0175,0005,0003,0183,
01538, SENADOR GUIOMARD ,0008,1090,0119,0045,0005,0039,0133,0220,0172,0002,0001,0175,
01538, SENADOR GUIOMARD ,0008,1201,0126,0048,0023,0037,0148,0235,0185,0002,0000,0187,
01538, SENADOR GUIOMARD ,0008,1376,0127,0071,0003,0033,0130,0236,0163,0001,0001,0165,
01538, SENADOR GUIOMARD ,0008,1066,0131,0061,0008,0041,0125,0233,0166,0004,0002,0172,
01538, SENADOR GUIOMARD ,0008,1139,0134,0087,0003,0056,0133,0282,0189,0002,0004,0195,
01538, SENADOR GUIOMARD ,0008,1228,0149,0053,0025,0030,0139,0224,0169,0000,0002,0171,
01538, SENADOR GUIOMARD ,0008,1236,0152,0038,0058,0073,0123,0242,0196,0004,0004,0204,
01538, SENADOR GUIOMARD ,0008,1368,0153,0047,0022,0036,0095,0182,0131,0002,0002,0135,
01538, SENADOR GUIOMARD ,0008,1210,0154,0078,0007,0057,0105,0242,0162,0002,0000,0164,
01538, SENADOR GUIOMARD ,0008,1260,0161,0037,0016,0044,0106,0192,0150,0005,0000,0155,
01538, SENADOR GUIOMARD ,0008,1317,0167,0054,0047,0082,0168,0309,0250,0001,0004,0255,
01538, SENADOR GUIOMARD ,0008,1295,0168,0044,0026,0027,0130,0204,0157,0002,0001,0160,
01538, SENADOR GUIOMARD ,0008,1309,0172,0066,0006,0041,0106,0214,0147,0000,0001,0148,
01538, SENADOR GUIOMARD ,0008,1333,0187,0084,0015,0050,0184,0325,0234,0005,0002,0241,
01538, SENADOR GUIOMARD ,0008,1023,0188,0048,0012,0053,0128,0233,0181,0001,0003,0185,
01538, SENADOR GUIOMARD ,0008,1210,0200,0076,0003,0042,0122,0242,0164,0001,0001,0166,
01538, SENADOR GUIOMARD ,0008,1082,0204,0078,0007,0056,0132,0272,0188,0001,0005,0194,
01538, SENADOR GUIOMARD ,0008,1244,0207,0019,0009,0012,0028,0061,0040,0001,0001,0042,
01538, SENADOR GUIOMARD ,0008,1392,0208,0051,0005,0038,0115,0207,0153,0002,0001,0156,
01538, SENADOR GUIOMARD ,0008,1422,0210,0054,0003,0021,0080,0157,0101,0000,0002,0103,
01538, SENADOR GUIOMARD ,0008,1481,0219,0088,0007,0041,0162,0297,0203,0005,0001,0209,
01538, SENADOR GUIOMARD ,0008,1139,0220,0080,0020,0072,0165,0323,0237,0003,0003,0243,
01538, SENADOR GUIOMARD ,0008,1228,0221,0090,0025,0044,0179,0315,0223,0002,0000,0225,
01538, SENADOR GUIOMARD ,0008,1210,0222,0084,0005,0041,0111,0239,0152,0002,0001,0155,
01538, SENADOR GUIOMARD ,0008,1236,0223,0065,0013,0044,0093,0204,0137,0000,0002,0139,
01538, SENADOR GUIOMARD ,0008,1309,0225,0077,0004,0027,0110,0216,0137,0000,0002,0139,
01538, SENADOR GUIOMARD ,0008,1066,0226,0083,0002,0037,0112,0237,0149,0001,0004,0154,
01538, SENADOR GUIOMARD ,0008,1090,0227,0067,0005,0038,0116,0227,0154,0003,0003,0160,
01538, SENADOR GUIOMARD ,0008,1163,0239,0066,0016,0029,0116,0213,0145,0000,0002,0147,
01538, SENADOR GUIOMARD ,0008,1155,0241,0077,0001,0057,0116,0252,0173,0001,0001,0175,
01538, SENADOR GUIOMARD ,0008,1422,0242,0116,0006,0046,0131,0296,0177,0002,0001,0180,
01538, SENADOR GUIOMARD ,0008,1090,0243,0087,0008,0033,0099,0220,0132,0000,0001,0133,
01538, SENADOR GUIOMARD ,0008,1210,0244,0093,0000,0044,0107,0244,0151,0000,0000,0151,
01538, SENADOR GUIOMARD ,0008,1090,0247,0091,0003,0033,0097,0224,0130,0002,0001,0133,
01538, SENADOR GUIOMARD ,0008,1457,0265,0014,0006,0012,0033,0060,0045,0000,0001,0046,
01538, SENADOR GUIOMARD ,0008,1031,0268,0079,0005,0049,0115,0246,0164,0002,0001,0167,
01554, MANOEL URBANO ,0003,1228,0041,0107,0016,0087,0134,0332,0221,0000,0004,0225,
01554, MANOEL URBANO ,0003,1228,0042,0101,0006,0092,0113,0314,0205,0005,0003,0213,
01554, MANOEL URBANO ,0003,1244,0043,0133,0023,0082,0119,0345,0201,0002,0009,0212,
01554, MANOEL URBANO ,0003,1244,0044,0118,0010,0081,0122,0327,0203,0003,0003,0209,
01554, MANOEL URBANO ,0003,1244,0045,0118,0024,0087,0133,0341,0220,0002,0001,0223,
01554, MANOEL URBANO ,0003,1244,0046,0109,0006,0087,0131,0331,0218,0001,0003,0222,
01554, MANOEL URBANO ,0003,1252,0047,0112,0009,0082,0115,0315,0197,0001,0005,0203,
01554, MANOEL URBANO ,0003,1252,0048,0099,0011,0097,0107,0309,0204,0000,0006,0210,
01554, MANOEL URBANO ,0003,1260,0049,0133,0012,0083,0124,0342,0207,0001,0001,0209,
01554, MANOEL URBANO ,0003,1260,0050,0103,0021,0087,0124,0316,0211,0001,0001,0213,
01554, MANOEL URBANO ,0003,1279,0051,0110,0015,0080,0106,0301,0186,0000,0005,0191,
01554, MANOEL URBANO ,0003,1279,0052,0100,0012,0079,0113,0299,0192,0001,0006,0199,
01554, MANOEL URBANO ,0003,1244,0059,0096,0013,0088,0122,0314,0210,0001,0007,0218,
01554, MANOEL URBANO ,0003,1252,0089,0111,0012,0069,0118,0303,0187,0002,0003,0192,
01554, MANOEL URBANO ,0003,1287,0100,0104,0023,0160,0045,0316,0205,0001,0006,0212,
01554, MANOEL URBANO ,0003,1295,0102,0014,0011,0015,0071,0103,0086,0001,0002,0089,
01554, MANOEL URBANO ,0003,1252,0107,0104,0015,0077,0129,0312,0206,0000,0002,0208,
01554, MANOEL URBANO ,0003,1244,0111,0126,0009,0069,0112,0309,0181,0000,0002,0183,
01554, MANOEL URBANO ,0003,1309,0126,0105,0024,0069,0092,0270,0161,0001,0003,0165,
01554, MANOEL URBANO ,0003,1309,0130,0111,0002,0038,0103,0257,0141,0000,0005,0146,
01554, MANOEL URBANO ,0003,1244,0132,0097,0006,0069,0109,0279,0178,0002,0002,0182,
01554, MANOEL URBANO ,0003,1228,0135,0112,0007,0087,0088,0287,0175,0000,0000,0175,
01554, MANOEL URBANO ,0003,1260,0139,0104,0018,0065,0109,0286,0174,0001,0007,0182,
01554, MANOEL URBANO ,0003,1228,0145,0112,0009,0080,0097,0291,0177,0001,0001,0179,
01554, MANOEL URBANO ,0003,1228,0150,0109,0008,0081,0099,0290,0180,0001,0000,0181,
01554, MANOEL URBANO ,0003,1260,0153,0028,0003,0024,0056,0112,0080,0002,0002,0084,
01554, MANOEL URBANO ,0003,1244,0154,0042,0007,0032,0098,0174,0130,0000,0002,0132,
01570, ASSIS BRASIL ,0006,1015,0027,0058,0020,0059,0128,0245,0187,0000,0000,0187,
01570, ASSIS BRASIL ,0006,1015,0028,0058,0012,0071,0106,0237,0177,0000,0002,0179,
01570, ASSIS BRASIL ,0006,1023,0029,0064,0022,0082,0158,0310,0240,0003,0003,0246,
01570, ASSIS BRASIL ,0006,1031,0030,0067,0024,0071,0151,0296,0222,0004,0003,0229,
01570, ASSIS BRASIL ,0006,1031,0031,0069,0018,0083,0136,0294,0219,0001,0005,0225,
01570, ASSIS BRASIL ,0006,1015,0036,0057,0006,0079,0148,0293,0227,0000,0009,0236,
01570, ASSIS BRASIL ,0006,1031,0037,0071,0011,0078,0139,0290,0217,0000,0002,0219,
01570, ASSIS BRASIL ,0006,1031,0043,0070,0019,0071,0148,0296,0219,0002,0005,0226,
01570, ASSIS BRASIL ,0006,1031,0052,0070,0011,0077,0135,0289,0212,0004,0003,0219,
01570, ASSIS BRASIL ,0006,1228,0066,0077,0027,0103,0168,0360,0271,0005,0007,0283,
01570, ASSIS BRASIL ,0006,1023,0073,0076,0007,0073,0151,0302,0224,0000,0002,0226,
01570, ASSIS BRASIL ,0006,1244,0078,0069,0020,0154,0083,0310,0237,0001,0003,0241,
01570, ASSIS BRASIL ,0006,1236,0079,0070,0019,0117,0027,0221,0144,0000,0007,0151,
01570, ASSIS BRASIL ,0006,1031,0090,0084,0008,0074,0134,0295,0208,0002,0001,0211,
01570, ASSIS BRASIL ,0006,1279,0093,0098,0000,0070,0167,0339,0237,0003,0001,0241,
01570, ASSIS BRASIL ,0006,1015,0095,0066,0008,0047,0117,0234,0164,0001,0003,0168,
01570, ASSIS BRASIL ,0006,1309,0104,0094,0008,0155,0047,0299,0202,0000,0003,0205,
01570, ASSIS BRASIL ,0006,1317,0108,0038,0010,0118,0004,0161,0122,0000,0001,0123,
01570, ASSIS BRASIL ,0006,1325,0114,0082,0002,0055,0004,0141,0059,0000,0000,0059,
01570, ASSIS BRASIL ,0006,1228,0129,0109,0003,0097,0155,0365,0252,0001,0003,0256,
01570, ASSIS BRASIL ,0006,1023,0130,0115,0009,0058,0137,0311,0195,0001,0000,0196,
01570, ASSIS BRASIL ,0006,1341,0149,0056,0023,0038,0093,0190,0131,0000,0003,0134,
01570, ASSIS BRASIL ,0006,1350,0150,0062,0011,0065,0181,0311,0246,0002,0001,0249,
